(sheÄ±)muoÄ±kea	gyroscope
@toacÄ±a	flaccid
@toacÄ±a	chaotic
@toacÄ±a	direct
@toacÄ±a	disturbs
@toacÄ±a	economy
@toacÄ±a	ethny
@toacÄ±a	porous
@toacÄ±a	ironic
@toacÄ±a	tide
@toacÄ±a	efficient
@toacÄ±a	organizes
@toacÄ±a	punishes
@toacÄ±a	kneads
@toacÄ±a	pinches
@toacÄ±a	suffers stress
@toacÄ±a	frame
@toacÄ±a	layer
@toacÄ±a	pastry
@toacÄ±a	fertilized egg
@toacÄ±a	unfertilized egg
@toacÄ±a	membrane
@toacÄ±a	spiritist
AqtatÄ±ka	Antarctica
ArabÄ±zu	Arabic language
Babadogua	country Barbados
BelÄ±jegua	country Belize
BeroamerÄ±ka	North America
BÄ±etoaq	post-Toaqic
ChuamerÄ±ka	Central America
DeranÄ±	Derani
DoÄ±che	German
DoÄ±chegua	Germany
Ebetoaq	Ewe language
Eseperaqto	Esperantic
Eseperaqtozu	Esperanto
Esyperaqto	Esperantic
Esyperaqtogua	"Esperantujo"
Esyperaqtozu	Esperanto
Faraqse	French
Faraqsegua	France
FÄ±etoaq	Vietoaq
FÄ±osazu	Viossa language
Guobasa	Globasa language
Gutaq	Gothic
HaÄ±'ataqgua	Armenia
HuÄ±gÄ±dezu	ygyde language
HÄ±qdÄ±agua	India
Iqlaqgua	England
Iqlaqtoaq	English language
IsÄ±kuÄ±gua	Ithkuilistan
IsÈ³laqgua	country Iceland
JamaÄ±kagua	country Jamaica
JunÄ±ko	Unicode
Juqguo	Chinese
Juqguogua	China
Kuenhazu	Quenya language
KÄ±symasy	Christmas
LatÄ±nazu	Latin language
Logalaqzu	Loglan language
Majaragua	country Hungary
MyleÄ±sÄ±ygua	country Malaysia
NamÄ±amerÄ±ka	South America
NamÄ±guaq	Antarctica
Nedelaq	Dutch
Nedelaqgua	Netherlands
Nedelaqzu	Dutch language
NÄ±hoq	Japanese
NÄ±hoqgua	Japan
NÄ±hoqgua	country Japan
Pasyka	Easter
Ponagua	ma pona
PuÄ±poqduq	is popular among
PÄ±kachu	is
RahÄ±nagua	country Ukraine
Romaguame	Roman Empire
Sakaqgua	country Georgia
Seperaqto	Esperantic
Seperaqtozu	Esperanto
SuloenÄ±	Slavic
SÄ±aomerÄ±ka	Native American
Toaq'aofa	Toaq Alpha
Toaqbeta	Toaq Beta
Toaqdeota	Toaq Delta
Toaqgama	Toaq Gamma
Toaqgua	Toaqistan
ToaqlÄ±zu	Toaqglish
Tubalugua	country Tuvalu
UkaÄ±nagua	country Ukraine
ZaÄ±che	Esperantist
aba	father
abugÄ±da	abugida
achoqrÄ±eq	saves on
achoqte	has been used up
achu	sneezes
achÄ±	fun
acÄ±	acid
acÄ±'aÄ±	acidic
acÄ±boq	antacid
adÄ±	fat
adÄ±'acÄ±	fatty acid
afarÄ±helekÄ±	eland
afarÄ±kune	African wild dog
afarÄ±lÄ±qsaq	oyan
agora	public gathering
ahaqdulÄ±lahÄ±	thanks God
aho	idiot
ahoge	ahoge
ahoÄ±	welcomes
ajenalÄ±q	adrenaline
ajÄ±	bow
ajÄ±che	archer
ajÄ±kea	crossbow
aka	root
akacÄ±a	acacia tree
akahua	tuber
akanose	AMAB
akazeo	tuber
akaÄ±	soreness
ako	peak
akuÄ±la	eagle
akuÄ±labÄ±	griffon
akÄ±mÄ±	active
akÄ±rakÄ±a	bloody
ala	Allah
alaÄ±	alga
aloe	aloe
alomoÄ±	allistic
alumÄ±q	aluminum
alumÄ±q'Ä±um	aluminium
alÄ±u	allium
amerÄ±kakenobo	Nearctic deer
amerÄ±kamelÄ±	American badger
amerÄ±kamusela	New World weasel
amerÄ±kanaomusela	New World otter
anho	bumps
anhoanho	chain reaction
anhotÄ±	bumps
anopoaq	break up
anou'Ä±deÄ±	love-panics
anoujÄ±	my love.
anÄ±	sand
anÄ±hÄ±	sandwhich
anÄ±jÄ±eq	pyramid
anÄ±karo	Barbary sheep
anÄ±me	anime
anÄ±pÄ±o	sandstone
anÄ±rea	beach
anÄ±toaÄ±	grain of sand
anÄ±tÄ±aq	sand-colored
ao'aoga	letter Ao
ao'aÄ±	realistic
aobÄ±	imaginary
aobÄ±fÄ±eq	makes up
aobÄ±gaÄ±	hallucinates
aobÄ±ge	hallucination
aobÄ±gÄ±	imaginative
aobÄ±huÄ±	unimaginative
aobÄ±jua	absurd
aobÄ±jÄ±aq	fictional world
aobÄ±kuq	says lie
aobÄ±kuqse	lie
aobÄ±lua	fictional story
aobÄ±luaÄ±	dadaistic
aobÄ±moÄ±	imagines
aobÄ±moÄ±	has fantasy
aofabeta	alphabet
aoga	frame
aoja	detached
aolua	fiction
aomo	island
aopaÄ±koÄ±	Ä±s an ascender
aotomoÄ±	has autism
aotue	hypothesis
apu	application
apÄ±	bee
apÄ±bue	hive
apÄ±bue	beehive
apÄ±duao	honey
apÄ±koaÄ±	honeycomb
apÄ±nÄ±	hop plant
aq'aqshe	letter Aq
aqbohuÄ±tuaruaq	blames, accuses
aqdepÄ±o	andesite
aqhy	sniffs
aqjykÄ±	polysterene
aqjÄ±kÄ±	polysterene
aqkuaq	letter Q
aqmana	letter Q
aqnha	intends to do
aqshe	donkey
aqshekebo	mule
aramoshÄ±	orgasms
aranekoaÄ±	spiderweb
arapaÄ±ma	arapaima
araÄ±	physical object
arÄ±eq	saves on
asaÄ±	dirt
asaÄ±dashÄ±	mud
asaÄ±zeo	vegetable
asenÄ±	arsenic
asheadaÄ±dÄ±u	modal logic
ashelaÄ±	letter Ã†
asholo	axolotl
asÄ±agazala	Asian gazelle
asÄ±ahepete	Asian mongoose
asÄ±apokesao	finless porpoise
asÄ±mÄ±qzeo	pawpaw
atom	atom
atomchu	atomic nucleus
atÄ±	on
aÄ±'aÄ±	smacks
aÄ±'aÄ±pu	letter AÄ±
aÄ±cha	resembles
aÄ±cy	integer
aÄ±dao	essence
aÄ±fuq	costume
aÄ±fuqpatÄ±	costume party
aÄ±geÄ±	dresses up as
aÄ±jÄ±	aji
aÄ±kopÄ±	mimic
aÄ±mu	not* the case
aÄ±pa	faerie
aÄ±poq	faerie
aÄ±pu	ghost
aÄ±puraq	ghostly
aÄ±py	faerie
aÄ±pÄ±	faerie
aÄ±se	impression
aÄ±sopo	isopod
aÄ±ueo	set
aÄ±zy	letter Y
bafaq	should
baga	pulls
bagacaha	breathes in
bagacha	ingressive
bagahÄ±e	tugs
bagasÄ±oq	pulley
bagatÄ±aÄ±	drawer
bage	baguette
baha'Ä±	BahÃ¡'Ã­
bakamoqda	Toaq illocution
bakanueq	beef
bakoy	makes requests
balaq	alarm
balu	should
banadÄ±um	vanadium
banaku	guanaco
banana	banana
baobaokenobo	muntjac
baoguÄ±cÄ±epabakashunaonÄ±ubÄ±u	sushi
baoguÄ±taqraka	rice tenrec
baoketo	beluga
baokuodepÄ±	killer whale
baokÄ±a	pink
baoluaq	white player
baopo	white playerâ€™s
baoruÄ±	silver
baosÄ±aÄ±toaÄ±	white blood cell
baozu	Cantonese
baqjo	banjo
baqpÄ±ry	vampire
baqraq	general
baqraÄ±	generic instance
baqse	typical result
baqshÄ±	entity
baqteÄ±	idealized shape
barabara	barbarous
barabeq	brussels sprout.
barara	*brrrrrrr*
barata	Indian
baratagua	India
baraÄ±'adu	Nilgiri tahr
barua	rose
bashoq	version
baso	bass
basue	commands
basue'eÄ±	high-handed
basuehe	haughty
basueruo	(being) superior
basuetoÄ±	is dominant
basÄ±le	basil
batata	sweet potato
batÄ±ny	Beltane
baÄ±gÄ±q	disassembles
baÄ±hÄ±u	canal
baÄ±loha	metal iron
baÄ±paq	is a part
baÄ±rÄ±aÄ±	scaffolding
baÄ±toaÄ±	brick
be'Ä±	grapevine
be'Ä±tÄ±	grapevine
beagoa	corner
beajÄ±oqkea	laptop
beamuao	cypress tree
beapue	arthropod
beapueq	knuckle-walks
beapueqhe	knuckle-walker
beaqchea	umbrella
beaqcÄ±oq	lever
beaqfua	column
beaqgoeq	fence
beaqluoq	scales
beaqme	ladder
beaqnaby	breadstick
beaqnhuo	ladder
beaqnÄ±u	bamboo
beaqtÄ±aÄ±	cage
beaÄ±	hangs on
beaÄ±gÄ±o	pendant light
beaÄ±pÄ±o	pendant
bebehaq	baby food
beberesÄ±u	viverrid
bebo	pregnant
becÄ±oq	lever
bede	is
beheq	pregnant
beleq	phlegm
beleqguele	pituitary gland
benhoq	umbilical cord
beochua	variable
beodama	unstable
beodaÄ±	variable
beodo	variable
beojeqda	genderfluid
beojey	genderfluid
beoq	base, foundation
beoqsaÄ±	chemical
beoreaÄ±	being stubborn
beoreaÄ±he	stubborn
beotoaÄ±	infinitesimal
beotoaÄ±dÄ±u	calculus
beotua	changes
beotue	event
bepoaÄ±	egg
beqbaÄ±	pinches
beqbo	is convex at
beqbÄ±a	swollen
beqdepÄ±	humpback dolphin
beqgÄ±u	ridge
beqheq	convex hull
beqjeoq	bumpy
beqra	date palm
beqrabeberesÄ±u	nandiniid
beqse	tumor
beqsÄ±u	swollen
beqtoq	overhang
beqzeq	benzene
bero	north
berohochu	north-east
berohore	north-west
beromerÄ±ka	North America
beromoa	north pole
beropoq	northerner
berosoq	north pole
beryzu	eberban
berÄ±lysaÄ±	beryllium
berÄ±lÄ±um	beryllium
betaruaÄ±cheabÄ±so	betacoronavirus
betoq	concrete
betoqpuo	concrete powder
beuq	pulls
beÄ±'o	wine
beÄ±gou	bagel
beÄ±ho	wine
beÄ±jaq	so much the case
beÄ±jaq	so much the case
beÄ±laq	stressed
beÄ±meÄ±laÄ±	letter W
beÄ±noq	wine
beÄ±so	virus
beÄ±tua	emphasizes
boa	neck
boafuq	scarf
boagÄ±a	choker
boam	low-pitched
boao	knows the answer
boaqfeo	oriented
boaqhuoÄ±	tree squirrel
boaqhuoÄ±sÄ±u	squirrel
boaqkahu	tree squirrel
boareÄ±	choker
boareÄ±my	choker
boaÄ±he	submissive
boaÄ±kuaÄ±	compliant
bobe	unborn child
boca	wasp
boceo	acquires
boche	owner
bocÄ±a	lacks
boduq	Vodun
bodyka	vodka
boe(sÄ±u)guaq	plain
boebeogÄ±o	is komorebi
boefuq	robe
boehaq	pancake
boejÄ±o	tent
boekÄ±oq	circle
boeme	salad
boenao	puddle
boepata	chip
boeqdÄ±aÄ±jodÄ±aÄ±	Boeing 747
boeteÄ±muhuaqtuamu	flattered
boetuo	sloth
bofaÄ±	common to own
bogÄ±	Bhogi
boko	shoves
boku	me
bokuaÄ±	feels greed
boleÄ±	rare to own
bologÄ±tom	phlogiston
bolÄ±a	pen
bomu	possession of
bonuamy	loot
bopÄ±osaÄ±	boron
boqdua	indeterminate
boqgoaÄ±cha	affricate
boqko	finds
boqlaq	consonant
boqsa	preventable loss
boqsoa	prevents
boqsulaq	plosive
boqtÄ±	obstructs
boqtÄ±e	obstructs
bore	flattens
boromÄ±q	bromine
boroq	boron
bosebue	wasp nest
boshao	wants to possess
boshaÄ±nue	renounces
boshaÄ±tao	discards
bosho	gains
bosho	gets
bosue	requests
bosÄ±a	unclaimed
bosÄ±abebue	orphanage
bota	holds off
boteq	pays
boteq	pays money
boteqdoa	sells, for money
bouba	lumpy
buachao	van
buachÄ±jÄ±o	abbey
buafa	moves house
buafa	moves house
buajeq	housemate
buajÄ±ome	neighborhood
buaqcha	unsuccessful
buaqchÄ±o	attempts
buaqmeo	frustrated
buaÄ±dekÄ±	ruler
buaÄ±duoÄ±	stretches
buaÄ±fa	journeys
buaÄ±huao	loose
buaÄ±jÄ±o	tower
buaÄ±jÄ±ojÄ±eq	rectangle
buaÄ±kua	hall
buaÄ±kÄ±oq	3D oval shape
buaÄ±kÄ±oqteÄ±	oval shape
buaÄ±muÄ±	wordy
buaÄ±mÄ±eqchuo	ruler
buaÄ±ne	length
buaÄ±nÄ±oq	tusk
buaÄ±rueq	taut
buaÄ±sÄ±oq	ellipse
buaÄ±toaÄ±	unit of length
bubeÄ±	indeed not so
bubu	not not the case
buby	feels good
buchÄ±cheykuq	says
buda	buddha
budachuaq	Buddhism
budachÄ±	Buddhist
budajÄ±uchaq	Buddha Jayanti
budakoko	Buddhist
buduoceaq	cheetah
buduÄ±	not enough
budÄ±e	warns
buedueq	lawn
bueguaq	territory
buemoe	feels at home
buenoÄ±	homework
buesoaq	lawn
buetÄ±	at home
buhuÄ±	nice
bujao	far from false
bujuÄ±	barely the case
bujÄ±qjeosuq	gatekeeps
buka	dares to do
bukache	adventurer
bula	bubble
bulahÄ±u	stream
bulame	foam
bulua	fiction
bulureÄ±feoq	Blu-ray disk
bumuojuÄ±	hardly
buojuq	accepts property
buoqgaq	hangs out with
buoqjÄ±	case
buoqlaÄ±	glyph
buoqlua	comedy
buoqse	folly
buoÄ±luaÄ±	darkly humorous
buoÄ±meoca	tragic
buoÄ±noaq	doomscrolls
buqbeq	muzzle
buqbÄ±u	proboscis
buqchulaq	schwa vowel
buqhÄ±ao	bites
buqjeoq	oral cavity
buqjÄ±aÄ±	bites
buqjÄ±aÄ±	kisses
buqkuoq	tooth
buqkÄ±aqkaro	serow
buqkÄ±aqnua	shaves
buqkÄ±aqpoke	bearded seal
buqluaofuo	is kissing
buqlÄ±a	cheek
buqlÄ±asho	debuccalizes
buqnao	saliva
buqne	mouthful
buqpÄ±o	tooth
buqshaÄ±ca	gobstopper
buqsoÄ±	pigs out on
buqtuaq	beak
buqtÄ±abÄ±u	pharynx
buqtÄ±etÄ±	velar
buraqsaÄ±	is
burasÄ±hebe	rubber tree
buruaq	denies
buruo	moss
buruonÄ±u	bryophyte
buruotÄ±e	mossy
burÄ±	brie
burÄ±aq	utopia
burÄ±aqkero	grapefruit tree
burÄ±u	returns
bushu	holy
bushudoÄ±	worships
bushumÄ±ochaq	Holy Saturday
butÄ±duo	moves away
buzolokÄ±a	ghost pepper
buÄ±	outside
buÄ±caha	breathes out
buÄ±ce	exit
buÄ±duotaq	expands
buÄ±duotaqtua	expands
buÄ±gaja	extraterrestrial
buÄ±jÄ±aÄ±	bacteria
buÄ±koe	excludes
buÄ±ku	uterus
buÄ±kuboaq	placenta
buÄ±kuboaq	placenta
buÄ±kubÄ±u	fallopian tube
buÄ±setÄ±eq	exhaust
buÄ±sha	gets out
buÄ±shuaq	emits
buÄ±toa	loan word
buÄ±tua	expels
byleq	phlegm
byleqguele	pituitary gland
bÃ³ekÄ±oqmuteÄ±	circular
bÄ±aca	illness
bÄ±acuaq	illness
bÄ±afoa	feels sick
bÄ±ahÄ±eq	throws up
bÄ±akaÄ±	virus
bÄ±akuaÄ±	has a sick
bÄ±alaÄ±	symptom
bÄ±aloq	has fever
bÄ±alÄ±ao	mo(u)ld
bÄ±amuasaÄ±	vaccine
bÄ±aobÄ±a	drunk
bÄ±aoca	confuses
bÄ±aochÄ±	holds confused
bÄ±aokoaÄ±	maze
bÄ±aokoÄ±	stumbles
bÄ±aonao	alcohol
bÄ±aonaosho	ferments
bÄ±aonaoshote	fermented
bÄ±aopÄ±aq	surprised
bÄ±aotoa	riddle
bÄ±apoe	quarantined
bÄ±aqbu	not enough
bÄ±aqpuoq	satisfies
bÄ±arÄ±o	miasma
bÄ±asaÄ±	toxic
bÄ±asaÄ±bÄ±a	poisoned
bÄ±atuataqtua	makes
bÄ±deoluaq	plays video game
bÄ±deoluaqmu	video game
bÄ±ecoetoa	suffix
bÄ±ejearÄ±aq	bar
bÄ±ekao	will
bÄ±ekÄ±e	thanks
bÄ±eseudÄ±u	aftermath
bÄ±eshata	disposable
bÄ±fÄ±	wifi
bÄ±gosy	bigos
bÄ±kÄ±ce	wiki entry
bÄ±kÄ±kaÄ±ce	wiki article
bÄ±kÄ±kaÄ±se	wiki article
bÄ±kÄ±kue	wiki
bÄ±kÄ±kueboe	wiki article
bÄ±laq	beep
bÄ±laÄ±	colon
bÄ±lÄ±ada	billiards
bÄ±olÄ±no	violin
bÄ±oq	departs
bÄ±osapoq	Viossa speaker
bÄ±osazu	Viossa
bÄ±oÄ±	leaks
bÄ±oÄ±chuao	leak
bÄ±qbÄ±q	million
bÄ±raÄ±	topic
bÄ±ru	virus
bÄ±rushÄ±	virion
bÄ±rutoaÄ±	virion
bÄ±so	virus
bÄ±tÄ±	grapevine
bÄ±tÄ±zeo	grape
bÄ±tÄ±zeome	bunch of grapes
bÄ±ucheoq	tube
bÄ±uchue	pipeline
bÄ±uluao	orifice
bÄ±ume	pipeline
bÄ±unÄ±aÄ±	worm
bÄ±utoaÄ±	ring
bÄ±utoaÄ±haq	bagel
bÄ±utuaÄ±	salp
bÄ±utÄ±aÄ±	barrel
bá»tua	brought about
caberubÄ±so	sarbecovirus
cadaÄ±	potential energy
cadÄ±u	physics
cagÄ±le	conducive
caha	breathes
cahahua	lung
cajoq	directly causes
cake	treat
cale	tends to cause
canhu	chestnut
canhy	chestnut
capaq	counts
capo	mamey sapote
caqbo	owns
caqche	administrator
caqdao	program
caqhe	dominant
caqhupame	keyboard
caqhupapaq	button control
caqjuao	setting
caqme	staff
caqruaq	decrees
caqsoÄ±	rebels against
caqsoÄ±che	rebellious
caqtoaÄ±	instruction
cara	shoots
cara	(agent) shoots
caramy	firearm
caruaÄ±	tzar
caruoq	directly causes
carÄ±	tsar
casaÄ±	energetic
casaÄ±'aÄ±	nutritious
case	process
casÄ±	almost the case
casÄ±ao	source
cateleq	Scottish
cateleqgua	Scotland
caÄ±chea	hard hat
caÄ±choamu	strong
caÄ±duadoa	assures that
caÄ±fuo	impacts
caÄ±fuoduy	gores
caÄ±guaqfurÄ±	earthquake
caÄ±guaÄ±	exercises
caÄ±hÄ±eq	hurls
caÄ±hÄ±o	hails
caÄ±jÄ±o	castle
caÄ±koy	flexes
caÄ±koÄ±	strides
caÄ±nÄ±ao	snow storm
caÄ±reo	brightly colored
caÄ±seaÄ±	liquor
caÄ±seoqtue	storm
caÄ±shÄ±y	becomes foggy
caÄ±tao	uses strength in
caÄ±zaq	comes into focus
ceabo	marsupial
ceahako	koala
ceahaq	dumpling
ceahua	pouch
ceakea	pocket device
ceanÄ±aÄ±	marsupial
ceaqpueqhe	unguligrade
ceaqpÄ±o	onyx
ceaqtechuo	nail clippers
ceaÄ±	suffers
ceke	iron
celadoa	cellar door
cem	normal
ceme	graph
cemedÄ±u	graph theory
cemeq	cement
ceocÄ±a	unbegun
ceokÄ±ao	entrance
ceoq	electrical
ceoqce	outlet
ceoqchua	nick (nickname)
ceoqchuoÄ±	electric cord
ceoqchuoÄ±	wire
ceoqgÄ±u	wire
ceoqkaÄ±deoq	e-mails
ceoqkue	e-book
ceoqloha	electrum
ceoqnhoq	electric cord
ceoqpeq	e-mail
ceoqshea	out of battery
ceoqshuo	battery
ceotuao	resumes
ceqbudachuaq	Zen Buddhism
ceqbudÄ±suq	Zen Buddhism
cesa	sizzles
cesanao	sparkling water
cesasha	boils
ceu	breathes
chahatapoq	Choctaw person
chakachaq	cicada
chakachaqchaq	summer day
chakopakÄ±ra	Chacoan peccary
chamu	is a way
chaobÄ±a	has motion
chaocaq	drives vehicle
chaoche	chauffeurs
chaochoaq	passenger
chaodoa	ships
chaofa	drives
chaoloaÄ±	some traffic
chaonÄ±e	is aboard
chaoshuo	parking lot
chaqbÄ±e	afternoon
chaqdÄ±aq	occurs daily
chaqgu	two-day period
chaqkue	day calendar
chaqmoa	time of day
chaqnaÄ±	happens today
chaqraomu	time of day
chaqtÄ±a	afternoon
chaqzeo	lime
chaso	tedious
chateÄ±dao	are instructions
chateÄ±kao	are instructions
chatoa	adverb
chatoame	adverbial phrase
chaÄ±boe	tea leaf
chaÄ±bÄ±o	teacup
chaÄ±heqmy	teapot
chaÄ±kafe	coffee with tea
chaÄ±nÄ±u	tea plant
chaÄ±tupa	teapot
chaÄ±tÄ±aq	tea-brown
chaÄ±tÄ±q	heart
chealaÄ±	diacritic
cheaqchÄ±a	trusts that
cheaqgÄ±	trustworty
cheaqsue	entrusts
cheaqzua	betrays
checu	and
checy	unstably
chedu	tricks
chemegeqjÄ±o	community center
cheocuoÄ±	and
cheodoa	exchanges
cheohÄ±ao	and
cheomudaÄ±	relation
cheoqdepÄ±	Fraser's dolphin
cheosoa	and
cheoteq	barters
cheu	deceitfully
chey	tricks
cheychuo	trap
cheycua	falls for trick
cheynhoy	hoax
cheyteoq	trick question
cheÄ±bea	knuckle
cheÄ±bÄ±o	cup
cheÄ±bÄ±u	ring
cheÄ±pueq	walks
cheÄ±pueqhe	digitigrade
cheÄ±se	finger print
cheÄ±sheaq	stands on his
cheÄ±sheaqhe	digitigrade
cheÄ±toq	nail
choaboq	consonant
choachuo	microphone
choadedÄ±u	phonaesthetics
choafua	podium
choahua	udder
choakao	voice recording
choakuq	says vocally
choakuqse	voice message
choapoa	consonant
choaqchao	taxi
choaqdoa	hospitable
choaqfa	visits
choaqgÄ±	welcome
choaqhuÄ±	unwelcome
choaqhÄ±o	welcomes
choaqhÄ±o	welcomes
choaqjuq	has guest(s)
choaqsheÄ±	is welcome
choaqsue	invites
choaqtao	pays a visit
choarÄ±a	vowel
choase	utterance
choasÄ±a	says nothing
choateÄ±	pronunciation
choatoaÄ±	phone
choatoaÄ±dÄ±u	phonetics
choazu	spoken language
choaÄ±cÄ±a	free
choaÄ±jaq	expensive
choaÄ±ne	price
choaÄ±nuÄ±	cheap
choaÄ±sao	expensive
choaÄ±soq	extravagant
choaÄ±sÄ±a	free
choaÄ±tuao	cheap
chochÄ±	chip
chodÄ±e	recommends
chofaÄ±	has common
chogÄ±q	dislikes
choha	base
choha'aÄ±	basic
choko	chocolate
chokokafe	caffe mocha
chokola	chocolate
chokopÄ±ehaq	cocoa
chokuaq	"likes"
choleÄ±	has niche
cholÄ±bo	cushioned
cholÄ±chuo	cushion
cholÄ±my	cushion
cholÄ±rÄ±aÄ±	cushions
chom	insect
chome	insect
chomehako	sloth bear
chomeheq	infested
chomesuhulÄ±q	aardwolf
chomÄ±a	popular
choq	uses
choqcha	is done using
choqchua	username
choqdo	Cheondoist
choqdÄ±e	offers tool
choqgeo	worn
choqkÄ±u	available
choqmuÄ±	is the intent
choqmy	gadget
choqmÄ±a	versatile
choqnÄ±u	herb
choqshea	goes unused
choqteÄ±	frontend
choqtuaÄ±	doll
chosheÄ±	accepting
chotaq	likes themselves
chouteÄ±	usage
choÄ±beqlaÄ±	letter Ã
choÄ±ceaq	claw
choÄ±ceaqjo	paw
choÄ±dea	(agentive) stabs
choÄ±goaÄ±	scratches
choÄ±gÄ±u	sharp edge
choÄ±hÄ±ao	stings
choÄ±jÄ±usaÄ±	is
choÄ±nÄ±oq	canine teeth
choÄ±peo	pierces
choÄ±poaÄ±zeo	cranberry berry
choÄ±pÄ±o	diamond
choÄ±saosa	hot sauce
choÄ±saÄ±	acid
choÄ±shoaÄ±sÄ±u	bird of prey
choÄ±soe	acid
chuabo	is called
chuaboe	name tag
chuachoq	assigns name
chuachoq	uses name
chuachoqhe	always uses name
chuacÄ±a	nameless
chuadua	knows by name
chuajoe	has title
chuakaÄ±	signs
chualuÄ±	expired name
chuaohÄ±eq	throws
chuaotoq	window ledge
chuaqbeo	revolutionizes
chuaqmÄ±u	classifies
chuasÄ±a	nameless
chuasÄ±agÄ±qtua	doxxes
chuataq	calls themselves
chuaÄ±cake	sorbet
chuaÄ±duao	frozen dessert
chuaÄ±dÄ±a	thaws
chuaÄ±hÄ±ao	ice-burns
chuaÄ±keto	bowhead whale
chuaÄ±my	(a) solid
chuaÄ±naopoke	harp seal
chuaÄ±noaÄ±	custard
chuchua	middle name
chucuao	limb
chuebaÄ±	chains together
chuechao	train
chuechue	choo-choo train
chuefa	follows
chuekÄ±q	movie episode
chuelua	episodic story
chuepatÄ±	procession
chuetao	does things
chuetÄ±eq	railway
chufaqkuq	interrupts
chuge	sexual
chugua	China
chuhaq	lunch
chujÄ±urÄ±oq	intersex
chukuq	mediates between
chumoalaÄ±	interpunct
chunÄ±	lewd
chunÄ±choleÄ±	has a fetish
chunÄ±de	sexy
chunÄ±huÄ±	perverted
chunÄ±moe	horny
chuocha	is done using
chuodoedoa	turns
chuomÄ±a	versatile
chuotÄ±aÄ±	toolbox
chuoÄ±	thread
chuoÄ±coe	fastened
chuoÄ±furÄ±	swings
chuoÄ±nhuo	filter, sieve
chuoÄ±nÄ±u	vine
chuoÄ±saÄ±	fibre
chupaq	middle
chupoe	kinky
chuqbeaq	chopsticks
chuqcheÄ±	chopstick
chuqchuo	cutlery
chuqchuosÄ±qkea	dishwasher
chuqdoa	gives food
chuqfurÄ±	has bulimia
chuqguaokenobo	marsh deer
chuqgÄ±	edible
chuqhuame	digestive system
chuqjearÄ±aq	restaurant
chuqjeoq	spoon
chuqjuao	diet
chuqkua	dining room
chuqnÄ±u	vegetable
chuqroe	healthy to eat
chuqrÄ±eq	fasts
chuqsao	fat
chuqsheq	table knife
churÄ±ohua	diaphragm
churÄ±oq	is a hybrid
churÄ±qkea	Turing machine
churÄ±qkeajeq	Turing-complete
chutÄ±	in the middle
chuzu	Chinese language
chuÄ±chuq	eats breakfast
chuÄ±duse	first impression
chuÄ±guÄ±	breakfast cereal
chuÄ±lÄ±o	north
chuÄ±lÄ±otÄ±	to the north
chuÄ±m	brush
chyreÄ±q	TR-affrication
chÄ±(jÄ±o)joaq	priest
chÄ±apoaÄ±	chia seeds
chÄ±aqbÄ±a	sentient
chÄ±aqduÄ±	hypervigilant
chÄ±aqdÄ±eq	notifies
chÄ±aqgaÄ±	intuits
chÄ±aqhe	personality
chÄ±aqhua	mind
chÄ±aqlÄ±aq	plural system
chÄ±aqme	plural system
chÄ±aqrue	not very aware
chÄ±aqsea	meditates
chÄ±aqsho	notices
chÄ±aqtÄ±	conscious
chÄ±aÄ±chua	pseudonym
chÄ±aÄ±gaÄ±	hallucinates
chÄ±aÄ±gaÄ±no	synaesthetic
chÄ±aÄ±jÄ±ao	false god
chÄ±aÄ±mÄ±utua	misinforms
chÄ±aÄ±noaq	misreads
chÄ±aÄ±retao	recovers
chÄ±aÄ±ruaq	states falsity
chÄ±aÄ±taosÄ±	careful
chÄ±aÄ±taq	paradox
chÄ±bu	delusion
chÄ±chedu	fools
chÄ±chey	fools
chÄ±cheykuq	lies in saying
chÄ±chÄ±	chirp-chirp bird
chÄ±chÄ±aÄ±	falsely believes
chÄ±cÄ±a	skeptical
chÄ±duÄ±	naive
chÄ±dÄ±e	suggests
chÄ±echa	learns
chÄ±eche	learner
chÄ±echefuaÄ±	student council
chÄ±echekata	student ID card
chÄ±echeme	school
chÄ±ecoaq	tame
chÄ±edoaq	campus
chÄ±edoasue	enrolls in
chÄ±eduqse	class
chÄ±efuaÄ±	learning
chÄ±efÄ±uq	school
chÄ±eguaÄ±	Ä±s a scholar
chÄ±eguo	lesson
chÄ±ekata	flashcard
chÄ±ekua	classroom
chÄ±ekue	textbook
chÄ±eme	class
chÄ±emegaq	classmate
chÄ±enoÄ±	homework
chÄ±enÄ±q	beginner
chÄ±epeloq	grade
chÄ±eq	intersects
chÄ±eqdao	hashtag
chÄ±eqdoa	shares
chÄ±eqduy	moves across
chÄ±eqgao	is over
chÄ±eqgaÄ±no	has synesthesia
chÄ±eqgaÄ±no	synesthetic
chÄ±eqteÄ±	cross
chÄ±eqtÄ±eq	crossroad
chÄ±etao	studies
chÄ±etoaÄ±	lesson
chÄ±etuache	teacher
chÄ±fa	chip
chÄ±fuÄ±	docile
chÄ±fÄ±uq	Church
chÄ±gÄ±	tenable belief
chÄ±juq	picks up
chÄ±kenueq	chicken wing
chÄ±kola	chocolate
chÄ±lua	myth
chÄ±luajÄ±q	mythical
chÄ±noa	unbelievable
chÄ±obo	repetitive
chÄ±okaodoakÄ±ubulureÄ±feoq	BD-RE
chÄ±okaodoakÄ±udÄ±bÄ±dÄ±	DVD-RW
chÄ±okaodoakÄ±usÄ±dÄ±	CD-RW
chÄ±qchuq	insectivorous
chÄ±qshÄ±qhua	antennae
chÄ±rala	hog deer
chÄ±rÄ±eq	critical
chÄ±se	belief
chÄ±shuaÄ±	naive
chÄ±sÄ±a	skeptic
chÄ±sÄ±a	skeptical
chÄ±sÄ±ahe	skeptic
chÄ±tao	remembers to do
chÄ±taobu	forgets to do
chÄ±toÄ±	manipulates
chÄ±tu	naive
chÄ±tuafuÄ±	naive
chÄ±tuafuÄ±	gullible
chÄ±u'aba	Chihuahua
coachuao	underpass
coaq'alÄ±u	garlic
coaqbarÄ±qcÄ±	rice
coaqchÄ±eluÄ±	tame
coaqkune	domestic dog
coaqluko	dog
coaqmusela	domestic ferret
coebuÄ±	offline
coeguboe	blister pack
coegÄ±a	adhesive tape
coegÄ±u	seam
coejeo	inalienably
coeke	button
coele	sticky
coeleduao	gum
coeme	structure
coemuo	connected
coepeq	sticky note
coepotÄ±sa	slime mold
coesaÄ±	glue
coese	is
coetano	clay
coetoa	affix
coetÄ±e	seals
coezy	glue
cokÄ±	institution
coq	representation
coqjÄ±e	is deemed to be
cotoa	quantifier
coubuaq	fails person
coushatatoaq	Coushatta
coutao	addresses
coutaÄ±	fulfils
cuaboq	mutes
cuabÄ±a	has trauma
cuage	triggers
cuakaÄ±	writes response
cuakuqse	response
cuamoe	relates to
cuaodÄ±u	(a) metaphysics
cuaojÄ±qzÄ±u	hyperreal number
cuaonaq	transgender man
cuaq	is the property
cuaqbo	contentive
cuaqchue	serial predicate
cuaqcÄ±a	particle
cuaqdÄ±u	theory
cuaqfÄ±eq	derives compound
cuaqke	is a specific
cuaqko	fills in the
cuaqkotoa	noun
cuaqkueqse	compound concept
cuaqkueqtoaÄ±	primitive
cuaqluaq	plays game
cuaqmaÄ±	fan
cuaqmuÄ±bo	verb
cuaqpÄ±e	raises a toast
cuaqraÄ±	abstract
cuaqsao	huge
cuaqtao	celebrates
cuaqtue	event
cuase	response
cuaÄ±cey	sniffles
cuaÄ±choatoaÄ±	liquid
cuaÄ±guaq	swamp
cuaÄ±heq	is wet
cuaÄ±laq	liquid consonant
cuaÄ±laq	liquid
cuaÄ±shÄ±qhua	rhinarium
cuaÄ±tue	flood
cucujÄ±	azalea
cueche	politician
cuecheme	political party
cuedÄ±u	politics
cuejoaq	ruler
cuekoeguo	election
cuekoy	talks
cueluaq	doms
cueme	state
cueq	public
cueqsoaq	park
cuesoÄ±	defiant
cuesoÄ±	a rebel
cuesÄ±achuaq	anarchism
cuesÄ±ame	anarchy
cuetaq	sovereign
cueteÄ±	polity
cuga	hemlock tree
cuhybÄ±a	has asthma
cukÄ±	nods
cula	is an image
cunamÄ±	tsunami
cuokeo	real
cuoÄ±	and
cuoÄ±my	binary relation
cuoÄ±soq	satisfies with
cupÄ±	mucosa
cuq	leaves
cuqdere	tsundere
cuse	spit
cutaq	with
cutua	satisfies with
cuÄ±kÄ±a	colour rose
cuÄ±kÄ±a	of color
cuÄ±q	profane
cyhyduohua	diaphragm
cyhyrÄ±o	oxygen
cysao	large number
cyse	spit
cytao	spits
cÄ±akuq	omits
cÄ±aluq	at peace
cÄ±amoe	feels empty
cÄ±ane	zero amount
cÄ±anhe	has zero extent
cÄ±aodua	has cultural
cÄ±aojeo	culturally true
cÄ±aolu	is a cultural
cÄ±cÄ±'a	cringes
cÄ±ebeaq	fishing rod
cÄ±ebÄ±u	sushi
cÄ±eche	fisherman
cÄ±echome	silverfish
cÄ±echuq	pescatarian
cÄ±eduy	wriggles
cÄ±ejuku	fishing
cÄ±ejuku	fishes
cÄ±ejÄ±aÄ±gue	fishing hook
cÄ±ereq	merfolk
cÄ±etuo	Water Moccasin
cÄ±fujuao	Zipf's law
cÄ±jue	June
cÄ±jueko	Juneteenth
cÄ±jÄ±eq	hexagone
cÄ±jÄ±eq	hexagon
cÄ±kata	six
cÄ±laqteÄ±	sixth tone
cÄ±m	dislikes
cÄ±obeo	goes through
cÄ±odaq	puberty
cÄ±okoaq	young adult
cÄ±olÄ±q	adolescent girl
cÄ±onaq	adolescent boy
cÄ±oq	button
cÄ±oqnhuo	panel
cÄ±oqtoq	control panel
cÄ±qpeqjÄ±	chimpanzee
cÄ±ry	chain
cÄ±rÄ±	chain
cÄ±seÄ±	shills
cÄ±toq	cube
cÄ±udoe	exhausts
cÄ±ugÄ±q	absorbs
dada	chest
dakÄ±	forehead
dama	is apt
dame	dame
dana	defeats
daobaq	file
daobeoq	USB stick
daochue	is an array
daochÄ±u	is an address
daocoe	is a label
daodo	informs
daodoa	submits
daodoa	submits the data
daofeoq	hard disk
daofeoqme	hard drive
daofoq	smartphone
daogaÄ±	has perception
daojaolaq	smartphone
daojuao	logic
daojuaodÄ±u	study
daojuq	accesses
daojuqkÄ±u	accessible
daojÄ±oqdÄ±u	computer science
daokaodaÄ±	Caodaist
daokaÄ±	inputs data
daokaÄ±chuo	input device
daokea	computer
daokoko	Taoist
daomÄ±eq	checks
daoraq	links
daosue	wants to know
daosÄ±ca	interests
daoteÄ±	file format
daoteÄ±dÄ±u	statistics
daotoaÄ±	word
daotoq	table
daozu	data format
dapa	hand palm
dapapueqhe	plantigrade
dapasheaqhe	plantigrade
daqboe	wall clock
daqbÄ±o	hourglass
daqchuq	chronophage
daqchÄ±u	time address
daqdeaÄ±	worthwhile
daqdekÄ±	timer
daqduaÄ±	due
daqfa	time-travels
daqgoa	spacetime
daqguaÄ±	works full-time
daqguo	time
daqgÄ±	is
daqgÄ±a	time zone
daqhe	usually the case
daqjao	temporally far
daqjeqme	state
daqjuÄ±	temporally close
daqko	is the
daqlÄ±a	timeless
daqme	time period
daqmeoq	happens slowly
daqmÄ±eqchuo	timer
daqmÄ±qbu	temporary
daqmÄ±qgÄ±q	temporary
daqmÄ±qjeo	universally true
daqne	amount of time
daqne	duration
daqnuÄ±	short in time
daqpaq	temporal slice
daqpuÄ±	happens often
daqrea	deadline
daqrÄ±aq	period of time
daqsao	long in time
daqsheÄ±	has free time
daqsheÄ±bo	has free time
daqshÄ±kogÄ±q	is, among
daqsuaÄ±	happens quickly
daruma	snowman
dasho	me
datoa	illocution
dazÄ±	Druze
daÄ±mono	demon
daÄ±moÄ±	imagines
daÄ±sÄ±u	plausible
deabuaq	misses
deachu	target
deagÄ±aq	banger
deakaÄ±	types text
dealaq	tap
deaqfuq	rug
deaqkÄ±ao	trapdoorway
deaqkÄ±aotoq	trapdoor
deaqkÄ±aq	carpet
deaqme	stairs
deaqnhuo	stairs
deaqsha	lands
deaqtÄ±q	floor tile
deaÄ±doa	gives reward
deaÄ±hÄ±o	recognizes
deaÄ±juq	gets reward
deaÄ±ne	status
debÄ±o	vase
decha	happens
dechey	charms
dechuo	ornament
dedoa	beautifies
deduo	dances
deduy	dances
dehea	pendant
dehea	piece of jewelry
dekaÄ±	calligraphs
dekuq	declaims
dekuqse	poem
delua	poem
dem	pushes
demeo	beautifully sad
demeoca	beautifully sad
demy	decoration
denÄ±my	denim
deochaq	Children's Day
deokÄ±aÄ±poq	nanny
deoq	tells
deoqchuaq	society
deoqkoy	uses
deoqpeq	letter
deoqrÄ±aq	chatroom
deoqtea	shy, reserved
depaq	ornament
depÄ±	common dolphin
depÄ±o	gem
depÄ±sÄ±u	oceanic dolphin
deqbo	has skill
deqcaÄ±	powerful
deqcaÄ±	mighty
deqchÄ±e	learns the skill
deqcÄ±a	disabled
deqcÄ±atÄ±ao	accessible
deqkuaqsue	challenges
deqmÄ±q	omnipotent
deqne	ability
dere	is obsessed with
derepoq	nerd
desaÄ±	makeup
desaÄ±bo	wears
desaÄ±cÄ±a	wears
desaÄ±teÄ±	is the makeup on
deto	fetus
detoa	poetry
detoache	poet
detuasaÄ±	make-up
deza	messy mess
doa	gives
doacheo	gives
doachÄ±u	array index
doagÄ±	generous
doahuÄ±	ungenerous
doajuoq	owes property
doakata	pre-paid
doaqbua	inhabits town
doaqcokÄ±	city government
doaqgoeq	fortification
doaraotÄ±	was at
doashoe	accepts
doasoa	donates
doasÄ±aÄ±bÄ±u	artery
doatao	devotes
doateaÄ±	(being) stingy
doaÄ±bÄ±u	loaf of bread
doaÄ±toq	breadboard
doecÄ±a	useless
doegaq	partner
doegoÄ±	repairs
doegÄ±tua	fixes
doehua	organ
doejeaq	enhances
doekao	program
doekaÄ±che	programmer
doeme	system
doemÄ±atoa	contentive word
doemÄ±eq	tests if
doepaq	component
doeshe	does
doetoa	particle
doetua	turns on
doezua	turns off
dohe	replaces
doje	enhances
dojo	dojo
dojuq	receives
doka	hits
dola	one dollar
dolom	drum
dom	inactive
domu	is busy
donata	donut
doqbÄ±deo(DBD)	GIF
doqbÄ±u	ring
doqhey	abbreviation
doqhuoÄ±poke	crabeater seal
doqjoq	dungeon
doqkopÄ±	summary
doqmuÄ±	concise
doqnuo	naps
doqshaÄ±	interrupts
doqte	abbreviation
doqzobo	shorts
dote	present
doÄ±che'Ä±um	germanium
doÄ±deaÄ±	has dignity
doÄ±doÄ±	mimics
doÄ±gÄ±q	despises
doÄ±jaq	admires
doÄ±jÄ±	has face
doÄ±mumÄ±a	respected
doÄ±mÄ±a	renowned
doÄ±puÄ±	renowned
doÄ±sÄ±eq	reveres
doÄ±taq	has self-esteem
doÄ±tÄ±ao	esteemable
doÄ±tÄ±ao	honors
duachÄ±o	recap
duadÄ±u	epistemology
duafa	explores
duafaÄ±	widely
duafuÄ±sÄ±a	mystery
duagÄ±	wise
duagÄ±kuqse	proverb
duahuÄ±	foolish
duahuÄ±poq	fool
duahÄ±aq	uneducated
duajua	mysterious
duakuaÄ±	knowledge-lust
duamaÄ±	philosopher
duaoboe	cookie
duaobÄ±u	donut
duaocea	pie
duaochaÄ±	sweet tea
duaoduaoreÄ±	donut
duaofaseo	jelly bean
duaohaq	dessert
duaoloha	is
duaomara	cotton candy
duaomuoÄ±haq	donut
duaonÄ±u	sugarcane
duaopuao	cotton candy
duaopuo	sugar
duaopÄ±ma	bell pepper
duaoreÄ±	donut
duaosaÄ±	sugar
duaroa	intuits
duasuao	important
duasuq	you-know-what
duasÄ±a	unknown
duatuataq	tells
duatuatoeq	passes down onto
duaÄ±	must be the case
duaÄ±dao	tautology
duaÄ±daotaÄ±	proves that
duaÄ±se	chore
dubo	typhus
duedaq	punctual
duehea	hint
duemÄ±u	is right in his
dueqchao	tractor
dueseÄ±	mathematical
duetÄ±ao	answers
dufaq	phenomenon
dufuq	disguise
dugaÄ±	takes
dujÄ±q	virtual
duoboq	blocks
duocaheq	stiff
duocaheqcÄ±a	lax
duocanoa	has impetus
duodeaq	vehicle
duodÄ±e	insists on
duogoÄ±	nurses
duohuame	muscular system
duokea	robot
duokea	motor
duolaÄ±	arrow
duomuoq	fluid
duoshaÄ±	stops moving
duosuaÄ±	fast
duotaq	vibrates
duotaqkea	vibrator
duotoaq	sign language
duoÄ±	gestures with
duoÄ±juÄ±	lasts
duqgÄ±ao	has drought
duqkuaÄ±	craves
duqse	habit
duru	larva
dutao	feigns
duy	moves
duybo	displaced
duyde	graceful
duyfÄ±e	clumsy
duygoÄ±	rehabilitates
duyhua	muscle
duykoy	gestures
duykuq	signs
duylaÄ±	gesture
duzoaÄ±ge	unconvincing
duÄ±bokuaÄ±	greedy
duÄ±bokuaÄ±	greedy
duÄ±charuaq	Gish-gallops
duÄ±doa	overwhelms
duÄ±ge	overstimulating
duÄ±gegaÄ±	overstimulated
duÄ±gÄ±q	not enough
duÄ±hÄ±oq	cocky
duÄ±juo	spam
duÄ±me	is too much
duÄ±paq	excessive part
duÄ±ruq	rainfall flood
dÄ±	may be the case
dÄ±abuchuo	ratchet
dÄ±ao	drop
dÄ±aokua	toilet room.
dÄ±aopÄ±o	dripstone
dÄ±aqkao	diary
dÄ±aÄ±jue	July
dÄ±aÄ±kata	seven
dÄ±aÄ±laqteÄ±	seventh tone
dÄ±aÄ±peoq	nitrogen
dÄ±ba	replaces
dÄ±bu	disallowed
dÄ±butÄ±	trespasses
dÄ±bÄ±dÄ±	DVD
dÄ±ecaq	pressures
dÄ±echoaÄ±	costs
dÄ±edoa	advises
dÄ±ekuq	suggests
dÄ±eqboqgÄ±q	connection
dÄ±eqce	server
dÄ±eqchÄ±u	web
dÄ±eqdeqse	is connectivity
dÄ±eqdoa	uploads
dÄ±eqdÄ±e	links
dÄ±eqjÄ±o	post office
dÄ±eqme	internet
dÄ±eqmy	packet
dÄ±eqne	is the size
dÄ±eqnua	downloads
dÄ±eqrÄ±aq	accessible from
dÄ±esoÄ±	argues with
dÄ±etaÄ±	convinces
dÄ±gÄ±q	disallowed
dÄ±kÄ±dÄ±kÄ±	dik-dik
dÄ±ochubÄ±e	afternoon
dÄ±ochuchuq	eats lunch
dÄ±odÄ±a	afternoon
dÄ±ojeaq	morning
dÄ±onuo	naps
dÄ±onuÄ±soq	winter solstice
dÄ±orÄ±pÄ±o	diorite
dÄ±osoqchaq	summer solstice
dÄ±osuÄ±chaq	winter solstice
dÄ±osÄ±aofuq	morning gown
dÄ±ou	sugar
dÄ±q	corner
dÄ±qbo	wrinkled
dÄ±qcÄ±a	smooth
dÄ±qdoa	bends
dÄ±qgoa	corner
dÄ±qmuoq	coarse, brusque
dÄ±qmÄ±a	rough, bumpy
dÄ±qmÄ±asuhu	warthog
dÄ±qnhuochao	articulated bus
dÄ±qsaq	triangle
dÄ±uche	scientist
dÄ±uche	researcher
dÄ±ucuaq	theory
dÄ±use	research
dÄ±usÄ±	analyzes
dÄ±yq	colour pink
eajÄ±aq	imaginary world
ealua	fiction
eamoÄ±	imagines
ebÄ±	prawn
echa	clown
echÄ±	key
ecogeq	estrogen
ego	self-image
ekuchuoÄ±	whip
ekujÄ±o	stable
ekukoÄ±	trots
ekÄ±de	Euclidean
elabo	red deer
eleme	elm tree
eloa	gold
eloakune	maned wolf
eloareo	gold-colored
eloatoejÄ±	Cape golden mole
eloatoejÄ±sÄ±u	golden mole
emojÄ±	emoji
eo	(ignoring
eoropa	Europe
epÄ±moe	excited
eq	is an instance
eq	is
eqbÄ±	nonbinary
eqkuq	letter Q
erÄ±q	Ä±s me
esa	10Â¹â¸ in number
esagÄ±	rocks
eserojeq	estrogen
eso	pike
ezuÄ±	(the abstract
eÄ±	plays role
eÄ±'eÄ±chÄ±	letter EÄ±
eÄ±chÄ±	ant
eÄ±my	role
facaq	leads
facha	is a way
fafa	pursues
fafÄ±a	leads
fagaq	goes with
fahaq	take-out
faheqchuo	luggage
fajeo	piece of trivia
fajuÄ±	passes
fakea	robot
fakÄ±u	reachable
falafeo	falafel
falanuka	falanouc
falanukasÄ±u	euplerid
fama	famous
famamaÄ±	fan
fanÄ±lapaq	vanilla extract
faojÄ±aq	collapsing
faqdekÄ±	alarm
faqgÄ±q	unhappens
faqjuÄ±	on the brink
faqtoa	verb
faqtoame	verb phrase
faqtoany	verb complex
fareÄ±	encircles
fase	trip
faseo	bean
faseodashÄ±	bean paste
fashaÄ±	stops
fashaÄ±chuo	brakes
fashaÄ±juÄ±	leaves behind
fashÄ±chuaq	fascism
fasÄ±	faces towards
fasÄ±ao	origin
fasÄ±e	follows
fasÄ±u	follows
fatao	runs errand
fatoÄ±	moves towards
faÄ±	common
faÄ±beta	common beet
faÄ±gedejoq	barley
faÄ±godeoq	barley
faÄ±gydejoq	barley
faÄ±jÄ±	earliest element
faÄ±lÄ±ao	common
faÄ±muÄ±	common
faÄ±ne	frequency
faÄ±poq	normal person
faÄ±py	normal person
faÄ±raq	vandal
faÄ±rÄ±oq	is mainstream
faÄ±teÄ±	canonical
faÄ±teÄ±hey	canonical form
faÄ±zu	Mandarin Chinese
feahuaq	outlives
feamy	residue
feao	feels distress
feaojua	eerie
feaolao	dreads
feaomoaq	has flashback
feaotoÄ±	harasses
febakoy	commands
febakoy	commands
fecÄ±e	sea star
feguguÄ±	5G
fejue	May
fejue	May
fejÄ±	clairvoyant
fejÄ±eq	pentagone
fejÄ±eq	pentagon
fejÄ±noaq	mind-reads
fekata	five
felaqteÄ±	fifth tone
felegyreÄ±dueq	Flegrean Fields
fenusÄ±	ex forma
feobo	faces direction
feoca	is directed at
feocaq	advises
feochuo	compass
feoduo	moves towards
feojeq	parallel
feojeqcÄ±a	perpendicular
feojeqgÄ±q	perpendicular
feomÄ±eq	navigates
feoq	circular
feoqcake	cookie
feoqkahu	ringtail
feotua	directs
feqnoaq	reads the room
fetÄ±q	pentomino
fey	solid
fey	feels stressed
feyjaÄ±	excited
feyjoaÄ±sÄ±	(hyper)vigilant
feÄ±jaq	furious
feÄ±kuaÄ±	irascible
feÄ±loq	boiling
feÄ±lÄ±	fairy
feÄ±meo	sulks
feÄ±rÄ±ome	wind storm
feÄ±seoq	storm
foa	feels
foajeo	"rings true"
foaqfua	cushion
foaqgÄ±	comfortable
foaqhuÄ±	uncomfortable
foaqjaÄ±	is satisfied
foatÄ±ao	is in the right
foazameme	vibe checks
foaÄ±	is a detail of
foaÄ±'Ä±deÄ±	detail-panics
foaÄ±sÄ±duÄ±	is petty about
foka	vodka
fokeÄ±	feels okay
fomo	strict
foq	phone
foqlaq	ringtone
foqpaÄ±	contact
foqsue	phones
forÄ±qsaÄ±	is
foso	you
fosoforo	phosphorus
fotoche	photographer
fotolea	photography
foÄ±ca	boring
foÄ±faÄ±	clichÃ©
foÄ±moe	bored
fu	child
fuaq	image
fuaqfÄ±eq	creates
fuaqheq	picture frame
fuaqkue	illustrated book
fuaqmu	world
fuaqmuoq	paint
fuaqnuoqchuo	mirror
fuaqse	sight
fuaqtao	takes a photo
fuaqtaotaq	takes a selfie
fuaqtuaÄ±	image
fuaÄ±joaq	chairperson
fuaÄ±laÄ±	branding
fuaÄ±mea	member
fubu	dives
fubuche	typical duiker
fubupu	dove
fufu	grandchild
fufufu	grand-grandchild
fukÄ±oq	egg
fuluo	fluorine
fumefÄ±tÄ±	hog-nosed skunk
fumeme	generation
fuocaÄ±	hard
fuochoq	with
fuocoe	adheres, sticks
fuofuaq	print
fuofuaqkea	printer
fuoke	fidgets with
fuokuaÄ±	touch-starved
fuqcea	pocket
fuqcÄ±a	naked
fuqguepaqnuachuo	iron
fuqheq	dresser
fuqluao	collar
fuqluaÄ±che	clown
fuqme	set of clothes
fuqrÄ±aÄ±	clothes hanger
fuqrÄ±aÄ±	clothes hanger
fuqsaÄ±	cloth
fuqsaÄ±chuo	loom
fuqtÄ±aoche	tailor
fuqtÄ±aÄ±	drawer
furÄ±	oscillates
furÄ±nuofua	hammock
furÄ±sa	voiced
furÄ±sÄ±a	voiceless
furÄ±tuÄ±fua	rocking chair
fusu	fossa
fÄ±aho	him
fÄ±akaÄ±se	foreword
fÄ±amaq	it
fÄ±amaq	it
fÄ±asoq	primate
fÄ±choÄ±laÄ±	letter V
fÄ±eqjoe	creative
fÄ±eqkuaÄ±	inspired
fÄ±eqkuaÄ±ge	inspires
fÄ±eqkuÄ±	is an
fÄ±eqno	canvas
fÄ±eqnÄ±eq	uncreative
fÄ±eqse	creation
fÄ±ete	hits on
fÄ±kuzeo	fig fruit
fÄ±meteÄ±	nominative case
fÄ±o	colour beige
fÄ±soq	is up next
fÄ±unuo	sleeps lightly
fÄ±utoe	notches
fÄ±utoe	notches
ga'achaq	Earth Day
ga'achuaq	environmentalism
ga'akÄ±oq	globe
gace	feels itchy
gafÄ±o	superficial
gaja	planet earth
gajachuaq	environmentalism
gajakÄ±oq	globe
gale	teaches
galese	is a school
galeÄ±	edible dormouse
galÄ±um	gallium
gam	cuboid
gamaly	camel
gamalysÄ±u	camelid
ganagaora	Gangaur
gane	chalk
ganechuo	stick of chalk
gaodeaq	ceiling
gaodÄ±aopÄ±o	stalactite
gaofeo	direction â€œupâ€
gaofuo	on top
gaogureq	adrenal gland
gaojeaq	rises
gaojÄ±qzÄ±u	surreal number
gaokoÄ±chuo	ladder
gaokoÄ±fua	stairway
gaokoÄ±nÄ±aÄ±	tree shrew
gaorea	upper surface
gaoshÄ±aq	upper leg
gaozÄ±u	positive number
gaqbÄ±a	feels lonely
gaqcÄ±a	alone
gaqcÄ±amoe	feels lonely
gaqdoa	shares with
gaqguru	kangaroo
gaqgurugua	Australia
gaqhaq	side dish
gaqjuÄ±	accompanies
gaqkoe	includes
gaqme	community
gaqme	is a group
gaqme	is a group
gaqnua	takes
gaqnuao	synapsid
gaqsy	goose
gaqsyrua	daisy
gaqsÄ±a	alone
gaqsÄ±ahe	solitary
gaqtao	takes part in
gara	stomach
garabÄ±a	feels nauseous
garaluce	gastric ulcer
garapue	gastropod
garapuekato	slug-cat
garu	combs
garuchuo	comb
gate	solid
gazala	typical gazelle
gaÄ±boq	covers up
gaÄ±bÄ±oÄ±	gets spotted
gaÄ±ca	induces in
gaÄ±chÄ±aÄ±	halluciates
gaÄ±cÄ±a	numb
gaÄ±gÄ±u	nerve
gaÄ±gÄ±ume	nervous system
gaÄ±hua	sensory organ
gaÄ±juq	audience
gaÄ±koy	acknowledges
gaÄ±kuq	relates
gaÄ±kÄ±u	perceptible
gaÄ±kÄ±ubu	imperceptible
gaÄ±muochaq	Bodhi Day
gaÄ±muomuo	enlightened
gaÄ±noa	hard to perceive
gaÄ±nose	sensory modality
gaÄ±raq	perceptual
gaÄ±se	perception
gaÄ±shuÄ±	hidden
gaÄ±shÄ±e	conscious
ge	stimulus
geachua	caption
geafa	ascends
geahoefeo	oriented
geameÄ±	mountain
geaqsaÄ±nao	mud
geaqzeo	vegetable
gearÄ±	tower
gearÄ±koê¡am	clock tower
geatÄ±aÄ±	elevator
gecaÄ±	vivid
gefeao	overstimulated
gegaÄ±	has perception
gegaÄ±	has perception
gegege	overstimulated
gegu	cartilage
gehÄ±aq	dull
gekuaÄ±	sensory-deprived
gekuaÄ±toÄ±	fidgets with
gelÄ±	bile
gem	happens with
gemanÄ±um	germanium
gemuaq	desensitized
gemÄ±a	bright
geneta	genet
genolaÄ±	gene
genome	genome
geo'aÄ±	archaic
geobÄ±a	senecent
geochua	deadname
geoduatua	makes
geodÄ±o	afternoon
geodÄ±u	archaeology
geomanÄ±umu	germanium
geopoq	old
geotoaq	proto-Toaqic
geoÄ±	rolls
geqcho	likes
geqfa	meet up
geqkoyrÄ±aq	forum
geqme	congress
geqry	gingery
geqsoa	introduces
gere	hedgehog
gereba	crawfish
gero	crane
gerou	crane
gerozeo	cranberry
gerue	faint
gerymanÄ±umy	germanium
gesuoÄ±	striking
getea	fears
getuq	hyperfixates on
geu	is
geÄ±beo	changes clothes
geÄ±cÄ±a	naked
geÄ±dutao	dresses up as
geÄ±fao	outerwear
geÄ±nua	takes clothing
geÄ±se	outfit
geÄ±sÄ±a	naked
geÄ±sÄ±ao	underwear
goachoq	uses
goadÄ±u	geometry
goafuaq	sculpture
goajaq	voluminous
goajeaq	spreads out
goamoa	point in space
goamÄ±q	ubiquitous
goane	volume
goanuaÄ±	physical money
goanuÄ±	spatially small
goaqchoacha	breathy
goaqgoaÄ±	polishes
goara	roars
goaraÄ±	physical thing
goasao	spatially big
goashea	void
goateÄ±	spatial
goaÄ±boe	tissue
goaÄ±cÄ±aduy	slithers
goaÄ±fuq	towel
goaÄ±goaq	slippery
goaÄ±kaÄ±	scrapes
goaÄ±nua	abrades
goaÄ±nua	abrades material
goaÄ±nua	wears
goaÄ±nua	scrapes
goaÄ±pÄ±o	grindstone
goaÄ±se	friction
goaÄ±sÄ±aduo	slips
goaÄ±zeo	berry
godoÄ±	pika
goeq	wall
goeqboe	curtain
goeqche	mason
goeqdÄ±u	masonry
goeqlaÄ±	number sign
goeqlea	mural
goeqpeq	wallpaper
goeqpoe	separated
goeqtoaÄ±	brick
goeqtÄ±esaÄ±	plaster
gohoshao	propositions
golaq	golem
golofe	golf
gometeÄ±	accusative case
gomo	government
goqfe	golf
gorÄ±laÄ±	gorilla
gorÄ±laÄ±	gorilla
goso	chicken
gosokubo	chicken egg
gosonage	chicken nugget
gosonagete	chicken nugget
gosonueq	chicken meat
gosopoaÄ±	chicken egg
gososhoaÄ±nueq	chicken wing
goutÄ±ao	and
goÄ±	treats
goÄ±choq	takes medication
goÄ±dÄ±u	medicine
goÄ±muo	cures
goÄ±nuo	under narcosis
goÄ±poaÄ±	medicine pill
goÄ±saÄ±	medicine
goÄ±saÄ±	medicine
goÄ±saÄ±che	pharmacist
goÄ±saÄ±shuo	pharmacy
goÄ±shue	hospitalized
goÄ±soarÄ±aq	nurse's office
goÄ±sÄ±	examines
goÄ±taÄ±	cures
goÄ±toaÄ±	pill
goÄ±toaÄ±kua	pill organizer
goÄ±toÄ±	treats
gu'aÄ±	split
guabua	inhabits country
guache	monarch
guaotuaq	pronghorn
guaotuaqsÄ±u	pronghorn
guaqbeodÄ±u	geology
guaqbeotua	terraforms
guaqbo	has territory
guaqbueche	aboriginal of
guaqdeaq	ground
guaqdÄ±u	topography
guaqdÄ±u	geography
guaqdÄ±uche	geographer
guaqfuaq	map
guaqfuaqche	cartographer
guaqfurÄ±dÄ±u	seismology
guaqguaÄ±	farmer
guaqguqnÄ±efa	chimpanzee
guaqgÄ±aÄ±chuo	hoe
guaqhuaÄ±	digs
guaqjeoq	cave
guaqkuoq	stone
guaqkÄ±aq	grass
guaqlabÄ±	true chameleon
guaqlabÄ±'aÄ±	chameleon
guaqlabÄ±sÄ±u	chameleon
guaqleoq(tao)kuaÄ±	territorial
guaqmuoq	ceramic
guaqmÄ±q	continent
guaqnueq	stomach
guaqnulÄ±	crude oil
guaqnÄ±ejeoq	cave or cavern
guaqpuao	sea of clouds
guaqsaÄ±	soil
guaqsaÄ±muoq	earthen
guaqshamu	potato
guaqteÄ±dÄ±u	geomorphology
guaqteÄ±dÄ±u	topography
guaqtoe	plows
guaqtoq	tectonic plate
guaqzeo	tuber
guaqzu	Polish language
guaseachaq	national holiday
guasoÄ±	is at war with
guasÄ±ao	origin nation
guaÄ±chaq	weekday
guaÄ±daq	work-time
guaÄ±duo	work shift
guaÄ±duÄ±bÄ±a	burnt out
guaÄ±gaq	co-worker
guaÄ±guo	task
guaÄ±hua	muscle
guaÄ±jea	hires
guaÄ±jÄ±oqkea	work computer
guaÄ±kua	office
guaÄ±leo	tries hard to do
guaÄ±leo	focuses on task
guaÄ±leoq	lazy
guaÄ±me	organization
guaÄ±mechuaq	communism
guaÄ±paqme	project
guaÄ±rÄ±eq	puts off
guaÄ±se	work
guaÄ±toqfua	workbench
guaÄ±tÄ±gaq	body-doubles
gubu	and
gubu	odd in number
gubutu	zero or one
gubuÄ±	nonbinary
gucheÄ±muq	shows the V sign
guedaÄ±	flexible
guedaÄ±bu	stiff
guekaÄ±	writes
guekuaÄ±	malleable
guele	gland
guelo	wolverine
guepoaqle	brittle
guesheaq	kneels
guesheaq	leans
gueteÄ±	bend
guezueq	warped
gugunobÄ±	AFAB
guheÄ±	twenty in number
guheÄ±cÄ±peoq	iron
guhuaq	more related
guja	is the relation
gujeo	and
gujeo	and
gujeqda	bigender
gujey	bigender
gujue	February
gukata	two
gukojuju	double-jumps
gulaq	gland
gulaqteÄ±	second tone
guluao	bilabial
guluaqmu	two-player game
gulueq	serves
gumÄ±e	amphibian
gumÄ±edaosaÄ±	DNA
gunu	gnu
guobe	cattle
guobekaro	muskox
guobenoaÄ±	cow's milk
guobenueq	beef
guobesÄ±u	bovid
guobo	pattern
guobo	is a form
guojuaq	happens *again*
guoko	is the
guola	wolverine
guom	wall
guomkoê¡am	wall clock
guonÄ±q	new
guoqpoq	asshole
guoraq	specific
guoso	cattle
guosÄ±	watches
guoteÄ±	pattern
guotoa	verb
gupaqcoaqluko	wolf-dog
gupaqkaro	Himalayan tahr
gupeoq	helium
gupoaÄ±	testis
gupu	rots
gupuguaqsaÄ±	composte
gupuheqmy	composter
gupuloha	rust
guputano	composte
guqchuechao	subway train
guqcoe	hangs
guqdÄ±aopÄ±o	stalagmite
guqfa	descends
guqfuq	undergarment
guqjÄ±aq	underworld
guqmuÄ±	metaphorical
guqsheaq	understands
guqtaq	vertical
guqtaqkahu	dibatag
guqtÄ±eqhuaÄ±	digs a tunnel
gure	both or none
gureq	kidney
gureqneogulaq	adrenal gland
gureqneosaÄ±	adrenaline
guru	guru
gurugu	croaks
gurÄ±opÄ±e	lungfish
gusa	at least one
gusaonelaÄ±	bicameral letter
gusaÄ±	emulsion
guseaq	bisexual
gushe	allows
gusheaq	stands bipedally
gusheaqhe	bipede
gushÄ±	is either
gusÄ±a	neither
gusÄ±eme	ordered pair
gusÄ±oqfa	bikes
gutoemy	pair of scissors
gutoeqnhuo	matrix
gutoeqpao	grandparent
gutoeqsuoq	grandchild
gutu	both
gutÄ±q	domino
guy	cloth
guyboe	cloth sheet
guÄ±beaq	pitchfork
guÄ±bÄ±u	sushi
guÄ±che	serialist
guÄ±coe	gluten
guÄ±dÄ±u	serial science
guÄ±muoq	dough
guÄ±nhoq	pasta
gÄ±a'eku	zebra
gÄ±aboqcÄ±ra	striped vontsira
gÄ±achea	turban
gÄ±akaq	strip
gÄ±akÄ±ao	gateway
gÄ±akÄ±aotoq	gate
gÄ±aleoq	fence
gÄ±aoguaq	desert
gÄ±aotue	dry spell
gÄ±apoke	ribbon seal
gÄ±aqbaÄ±	produces
gÄ±aqbÄ±u	flute
gÄ±aqche	musician
gÄ±aqdoa	performs music
gÄ±aqduo	dances to music
gÄ±aqduy	dances
gÄ±aqfÄ±eq	composes music
gÄ±aqjaÄ±	vibing
gÄ±aqkaÄ±	composes music
gÄ±aqkaÄ±se	music score
gÄ±aqkoÄ±	walks to music
gÄ±aqpueq	tapdances
gÄ±aqshuaq	plays music
gÄ±aqshuaq	plays music
gÄ±aqshuaq	produces music
gÄ±aqteÄ±	melody
gÄ±aqtua	makes music
gÄ±arueqluaq	play tug of war
gÄ±aÄ±chuo	pickaxe
gÄ±aÄ±kaÄ±	carves
gÄ±aÄ±kuq	carves writing
gÄ±aÄ±kuqkaÄ±	carves writing
gÄ±aÄ±reo	pencil
gÄ±aÄ±reosheq	pencil sharpener
gÄ±aÄ±reoshuo	automatic pencil
gÄ±aÄ±te	carved
gÄ±aÄ±tedÄ±u	entomology
gÄ±cacÄ±a	in vain
gÄ±doa	rewards property
gÄ±ebÄ±u	sleeve
gÄ±ekea	robotic arm
gÄ±ekoê¡am	wristwatch
gÄ±eshÄ±oboe	cape
gÄ±faq	good occurrence
gÄ±huaq	better than
gÄ±jao	is safe
gÄ±koy	praises
gÄ±kuaochaq	Good Friday
gÄ±lÄ±e	has positive
gÄ±majÄ±	blessed
gÄ±muo	perfect
gÄ±mÄ±u	approves
gÄ±ne	has worth
gÄ±neqjuq	gets lucky
gÄ±neqnu	fortunately
gÄ±nu	fortunately
gÄ±nÄ±q	fresh
gÄ±ochuao	window
gÄ±ocÄ±oq	light switch
gÄ±odoa	lights
gÄ±odÄ±eq	lights
gÄ±ogeo	CMB
gÄ±ohua	photophore
gÄ±ojÄ±o	lighthouse
gÄ±okusu	jack-o'-lantern
gÄ±okÄ±oq	lightbulb
gÄ±olÄ±eq	prism
gÄ±omy	light
gÄ±onuoqchuo	mirror
gÄ±onÄ±aq	light year
gÄ±opoa	opaque
gÄ±orÄ±a	transparent
gÄ±oshuaq	shines
gÄ±osoaÄ±	ray of light
gÄ±otÄ±	(object
gÄ±otÄ±cÄ±a	unilluminated
gÄ±otÄ±e	opaque
gÄ±otÄ±tuao	ill-lit
gÄ±ozÄ±a	emits light
gÄ±ozÄ±a	emits
gÄ±po	buddy
gÄ±qbuoq	ironic
gÄ±qduÄ±	not enough
gÄ±qkuq	sarcastic
gÄ±qmÄ±aÄ±	alliterates with
gÄ±qtÄ±	absent
gÄ±qtÄ±sha	departs
gÄ±ruo'oma	benign tumor
gÄ±soq	is the best
gÄ±sÄ±o	good idea
gÄ±toaÄ±	score point
gÄ±toÄ±	treats
gÄ±uchoÄ±	blade
gÄ±uduo	moves along path
gÄ±ufa	goes along path
gÄ±umeÄ±	ridge
gÄ±unhuo	line
gÄ±unuÄ±	narrow
gÄ±ureq	stickman
gÄ±usao	wide
habanero	habanero pepper
habelÄ±na	collared peccary
habÄ±	bird
haga	feels a tickle
hajao	neurodivergent
hajapurune	apricot tree
hajapuruq	apricot tree
hajataqpurune	apricot tree
hajuÄ±	neurotypical
haka	wing
hakashuo	tuber
hako	bear
hakokato	binturong
hakosÄ±u	bear
halapenho	jalapeÃ±o pepper
halobÄ±q	Halloween
hamonÄ±ka	harmonica
hamoÄ±gua	amoeba
hanuka	Hanukkah
hanumaqjÄ±u	Hanuman Jayanti
haogaq	hangs out with
haogÄ±	welcome
haohao	thingamajig
haohuÄ±	unwelcome
haotao	does the salient
hapaka	alpaca
hapÄ±	bee
hapÄ±a	harpy
hapÄ±duao	honey
hapÄ±saÄ±	beeswax
haqbaÄ±case	recipe
haqbaÄ±che	cook
haqbaÄ±kua	kitchen
haqbaÄ±kua	kitchen
haqbaÄ±rÄ±oq	farm
haqboe	menu
haqbuchuq	has pica
haqbygy	hamburger
haqbÄ±u	esophagus
haqchaÄ±	soup
haqche	cook
haqchuq	eats food
haqcÄ±ao	cuisine
haqcÄ±aruoÄ±	scrawny
haqcÄ±u	vomits up
haqcÄ±ukuaÄ±	feels nauseous
haqdoa	feeds
haqfa	out for food
haqfuq	apron
haqfÄ±eq	invents new food
haqgu	eel
haqgulaÄ±	Hangul
haqheqmy	takeout box
haqhuapue	gastropod
haqjeoq	bowl
haqjueqkea	blender
haqjuq	obtains food
haqjuq	feeds themselves
haqjuqbÄ±u	digestive tract
haqkahahua	crop
haqkuaÄ±	craves food
haqlaÄ±	Han character
haqlueqche	waitron
haqly	snack
haqmÄ±laÄ±	hanzi
haqnhuo	buffet
haqpaoche	farmer
haqpaodÄ±u	agriculture
haqpaoguaq	farmland
haqpaorÄ±aq	farm
haqpaq	ingredient
haqpuÄ±	feast
haqsaokua	dining hall
haqshuaq	farms
haqshuo	food supply
haqsoy	plate
haqsue	orders
haqsÄ±a	vampire
haqtoaÄ±	nutrient
haqtoq	plate
haqtoq	plate
haqtÄ±ao	food
haqzu	CJK language
haqzy	hanzi
hara	scorpion
haranekoaÄ±	spiderweb
harÄ±	wizard
hasa	sighs
hashu	sneezes
hashufuq	handkerchief
hashÄ±dao	hash-tag
hatÄ±ao	is customizable
haÄ±gÄ±q	case only then
haÄ±ku	haiku
haÄ±nu	case already
heaqfa	carries
heaqmu	carried
heaqshaÄ±	drops
heaqsho	picks up
heaqshuo	inventory
heaqtÄ±ao	portable
heaqtÄ±ao	portable
hebesaÄ±	rubber
hedeaÄ±	status
hehaqraÄ±ruatÄ±tÄ±eq	HRT
hekero	maple tree
hekuchuoÄ±	whip
hekuq	says
helemo	elm
heleq	elbow bone
helÄ±um	helium
heno	version
heo	and
heocuage	allergen
heocuahe	allergic
heodua	can distinguish
heohueq	is a mark
heojeymaÄ±	heterosexual
heomaÄ±	straight
heomaÄ±	heteromantic
heome	heterogenous
heomÄ±a	varied
heomÄ±u	act of hypocrisy
heopoq	outsider
heoqgÄ±abo	armadillo
heoqshaq	belly
heose	is a byproduct
heoseaq	heterosexual
heoseje	LGBTQ
heoshaq	side
heosÄ±ca	distracts
heotÄ±	off
hepe	herpes
hepetenuÄ±	dwarf mongoose
hepetesÄ±u	mongoose
heqbeq	looks stuffy
heqcheose	mixture
heqfa	elf
heqfuq	purse
heqgoa	vessel
heqjeoq	bowl
heqma	container
heqmy	container
heqmy	container
heqmy	container
heqnÄ±u	potted plant
heqruaq	asserts
heroe	heroic
heroe'aÄ±	heroic
heruo	arrow
heseoq	climate
hesÄ±a	empty set
hey	and
hey	instance
heydaÄ±	alternative
heytou	is nonfungible
heytuqfuaq	NFT
hezÄ±	plasma
hezÄ±kÄ±oq	plasma ball
heÄ±gazeo	acorn
heÄ±gucheÄ±	duodenum
heÄ±gujue	December
heÄ±gutuaq	Asian swamp deer
heÄ±gÄ±e	squid.
heÄ±gÄ±echuq	bottlenose whale
heÄ±jue	October
heÄ±kata	ten
heÄ±py	teenager
heÄ±shÄ±jue	November
heÄ±shÄ±jue'aramoshÄ±cÄ±aguo	No Nut November
hoaqdoaÄ±	toast
hoaqfuÄ±	flammable
hoaqgÄ±o	firelight
hoaqhÄ±ao	burns (injury)
hoaqkÄ±u	flammable
hoaqleq	flame
hoaqluq	smolders
hoaqluÄ±	charcoal
hoaqnao	alcohol
hoaqpuao	smoke
hoaqpuo	ash
hoaqpÄ±o	coal
hoaqpÄ±otuÄ±	dragon
hoaqraq	nettle
hoaqrÄ±o	plasma
hoaqrÄ±o	smoke
hoaqshuao	phoenix
hoaqtue	fire
hoaÄ±duoÄ±	goes on and on
hoaÄ±haq	leftover food
hoaÄ±nu	still the case
hobÄ±	sheep
hobÄ±che	shepherd
hobÄ±kÄ±aq	wool
hobÄ±nueq	mutton
hochu	east
hochupoq	easterner
hoe'achu	sun-sneezes
hoeboe	sun disks
hoebuaq	brown dwarf
hoechuq	photosynthesizes
hoecÄ±ao	Toaq culture
hoedÄ±u	astronomy
hoefu	Toaqist
hoegoeq	awning
hoegua	Toaqland
hoegÄ±o	sunlight
hoehako	sun bear
hoehÄ±ao	gets sunburnt
hoejÄ±ao	solar deity
hoejÄ±aÄ±	navigates
hoekaqshÄ±a	sunglasses
hoeloha	gold
hoelohareo	gold-colored
hoeluo	solar system
hoeluÄ±	stellar remnant
hoeme	constellation
hoemÄ±a	sunny
hoemÄ±ao	solar eclipse
hoene	hour
hoenoaÄ±	sunscreen
hoepoq	alien
hoepoqchao	UFO
hoerua	sunflower
hoerÄ±qpÄ±o	chrysoberyl
hoesaÄ±	helium
hoesaÄ±	helium
hoeshÄ±y	sunset
hoesoaÄ±	sunbeam
hoesÄ±oq	galaxy
hoesÄ±u	shiny
hoetoa	word in Toaq
hoetoq	solar panel
hoetÄ±aq	suntanned skin
hoetÄ±e	darkened screen
hoezaq	sunrise
hoezeo	nightshade
hoezu	Toaq language
hohao	he
hojÄ±	us
hokapÄ±	okapi
hoku	compressed
hokÄ±	hockey
holÄ±	Holi
homalÄ±	ex forma
homaqrÄ±oq	animacy class
homopapy'omabÄ±ru	HPV
honÄ±	is this
hopa	satisfied by him
hoqkeo	however the case
hoqraÄ±	abstract
hoqsa	jaguar
hoqsÄ±e	case afterwards
hoqtekÄ±	computer
horachÄ±u	is the time
horaÄ±	animate
hore	west
horepoq	westerner
horolo	Xorlo
hota	=
hoto	bone
house	suggestion ğŸ¡
housÄ±	ear
housÄ±karo	beira
hoÄ±ly	euler's number
hoÄ±mu	following
hoÄ±toa	anaphora
hoÄ±toa	pro-word
huabo	has body part
huaduo	gestures
huakea	prosthetic limb
huakuaq	expresses
huakuq	signs
huakuqtoaÄ±	chereme
huaohua	dewlap
huaomoe	feels relaxed
huaopaq	flap
huaoreÄ±	loosely surround
huaorueq	stretchable
huaorueqchuo	bellows
huapaq	body part
huaqchua	a
huaqloÄ±	envies
huaqmea	majority
huaqmoe	feels arrogant
huaqsho	surpasses
huaqsoÄ±	tries to one-up
huarueqduo	stretches
huaÄ±chao	excavator
huaÄ±chuo	shovel
huaÄ±chuokenobo	fallow deer
huaÄ±lyjÄ±aÄ±	spoons
huaÄ±lyreaq	spoon
huaÄ±my	spoon
huaÄ±myne	spoonful
hue'o	velvet
huecea	pillow
huela	vulva
huela'aÄ±	yonic
huelo	velvet
huelobosa	Asian hornet
hueq	surface, facet
hueqjo	tetrahedron
hueqsÄ±	gropes
huku	squash
hukushu	squash
hukÄ±	punishes
hunagÄ±e	tentacle
huobo	has the sound
huochoÄ±	ear-piercing
huocÄ±a	deaf
huocÄ±acÄ±ao	Deaf culture
huode	sounds beautiful
huodeq	can hear
huofÄ±e	sounds ugly
huogaÄ±kea	microphone
huoge	emits sound
huohuahupÄ±	bat-eared fox
huohuasaÄ±	cerumen
huohuÄ±	sounds bad
huohÄ±aq	hard of hearing
huojÄ±oq	antenna
huonoaq	reads audiobook
huonueqhua	earlobe
huopuao	muffled
huosoakea	hearing aid
huosÄ±u	sounds like
huotoaÄ±	phone
huoÄ±bÄ±o	cup
huoÄ±cÄ±a	frog
huoÄ±sÄ±a	tailless
hupa	pushes
hupa(mÄ±eq)chuo	barometer
hupacaha	breathes out
hupacheoq	tube
hupacÄ±oq	button
hupareÄ±kafe	caffe espresso
hupÄ±	fox
hupÄ±shÄ±ukune	olingo
huqjeo	indeed
huqkÄ±a	snow leopard
hurahe	witch
hurÄ±gupaqluko	wolf-dog
hurÄ±luko	wolf
huÄ±bu	not bad
huÄ±caqruaq	blames
huÄ±che	villain
huÄ±choq	wastes
huÄ±chÄ±aÄ±	morally wrong
huÄ±chÄ±chuaq	cult
huÄ±daÄ±moe	feels anxiety
huÄ±daÄ±moÄ±	feels anxiety
huÄ±daÄ±sÄ±	worries
huÄ±faq	goes wrong
huÄ±hota	metastasizes
huÄ±jua	silly person
huÄ±jua	abnormal
huÄ±juÄ±shaÄ±	abandons
huÄ±koe	blames
huÄ±koy	condemns
huÄ±kuaÄ±	sadistic
huÄ±kuÄ±huÄ±	punishes
huÄ±loeq	rots
huÄ±lÄ±e	is negatively
huÄ±lÄ±echo	masochist
huÄ±lÄ±etua	punishes
huÄ±majÄ±	curse
huÄ±majÄ±	cursed
huÄ±majÄ±bo	cursed
huÄ±moegaq	feels sympathy
huÄ±moÄ±	feels anxiety
huÄ±mÄ±u	disapproves
huÄ±neqjuq	gets unlucky
huÄ±neqnu	unfortunately
huÄ±nu	unfortunately
huÄ±nua	steals
huÄ±nuy	takes revenge on
huÄ±nÄ±q	viral
huÄ±nÄ±qdoe	virus
huÄ±paq	discontent
huÄ±poqnua	abducts
huÄ±pueq	commits treason
huÄ±pÄ±otuÄ±	dinosaur
huÄ±ruo'oma	malignant tumor
huÄ±sao	intimidating
huÄ±seoq	storm
huÄ±seoqjaomoe	feels chrysalism
huÄ±shao	is malicious
huÄ±shaofey	paranoid
huÄ±shÄ±q	stinks
huÄ±shÄ±qmelÄ±	stink badger
huÄ±taoheq	jail
huÄ±taojÄ±o	jail
huÄ±toaÄ±	penalty point
huÄ±toÄ±	mistreats
huÄ±toÄ±'eÄ±	bully
huÄ±tuaruaq	blames
hÄ±a	is
hÄ±a	is
hÄ±am	dangerous
hÄ±aoboq	protects
hÄ±aobu	safe
hÄ±aocaÄ±	damaging
hÄ±aoce	injury
hÄ±aochuo	weapon
hÄ±aocÄ±a	safe
hÄ±aocÄ±a	safe
hÄ±aocÄ±asÄ±o	idea of safety
hÄ±aodaÄ±moe	feels unsafe
hÄ±aodaÄ±ruaqse	warning
hÄ±aodaÄ±sÄ±amoe	feels safe
hÄ±aodea	batters
hÄ±aodoemÄ±etoaÄ±	virus
hÄ±aogÄ±q	heals
hÄ±aoheaq	armed
hÄ±aojao	safe from danger
hÄ±aojoaÄ±sÄ±	vigilant
hÄ±aojuqcho	masochist
hÄ±aokea	virus
hÄ±aokuaÄ±	aggressive
hÄ±aoleo	attacks
hÄ±aomoe	feels hurt
hÄ±aonuÄ±	pathogen
hÄ±aopuo	gunpowder
hÄ±aorÄ±eqsoa	rescues
hÄ±aorÄ±eqsoache	rescuer
hÄ±aosaÄ±bÄ±a	poisoned
hÄ±aose	wound
hÄ±aoshao	is cruel towards
hÄ±aosuao	severe
hÄ±aotaocho	sadist
hÄ±aote	hurt
hÄ±aotoaÄ±	ammunition
hÄ±aotuafaÄ±	is cruel towards
hÄ±aotue	disaster
hÄ±aotÄ±echuo	bandage
hÄ±aqkuaÄ±	feels burnt out
hÄ±aÄ±na	hyena
hÄ±bu	whatever
hÄ±derudo	raspberry plant
hÄ±derudo	red raspberry
hÄ±e'eku	hippopotamus
hÄ±echao	wagon
hÄ±efa	carries
hÄ±eheku	hippopotamus
hÄ±ejeoq	bucket
hÄ±ejeoqny	bucketful
hÄ±ekebo	hippopotamus
hÄ±eku	liver
hÄ±ena	hyena
hÄ±eq	throws
hÄ±eqboe	frisbee
hÄ±eqbÄ±a	feels nauseous
hÄ±eqbÄ±u	cannon
hÄ±eqbÄ±ukea	gun
hÄ±eqfuo	pushes on
hÄ±eqgÄ±qfuo	pulls on
hÄ±eqjuq	catches
hÄ±eqmÄ±	knight
hÄ±eqnuao	bow
hÄ±eqnuaobeaq	arrow
hÄ±eqnuaohaq	arrow
hÄ±eqpoaq	explodes
hÄ±eqpoaqkea	bomb
hÄ±eqse	projectile
hÄ±eqtaq	jumps
hÄ±esÄ±aÄ±bÄ±u	artery
hÄ±etÄ±sha	brings
hÄ±guana	iguana
hÄ±gÄ±e	hygienic
hÄ±mÄ±eq	classifies
hÄ±odÄ±eq	sends greetings
hÄ±ohaÄ±	acknowledges
hÄ±oqdeaÄ±	worthy
hÄ±oqgÄ±q	ashamed
hÄ±oqjue	Pride Month
hÄ±oqkuq	brags about
hÄ±oqshuÄ±kuq	humble brags
hÄ±pÄ±	hippie
hÄ±pÄ±	hippie
hÄ±qdu	Hindu
hÄ±qsoq	is the latest
hÄ±raÄ±	is
hÄ±u'eku	hippopotamus
hÄ±uguao	fork in a river
hÄ±uguaoguaq	delta
hÄ±uguaome	delta
hÄ±uguoq	mouth of a river
hÄ±upÄ±o	quartz
jabÄ±	predicate
jachuao	lambda slot
jachuaocÄ±a	nullary
jacoese	binding
jada	Yalda
jaka	true jackal
jama	influences
jao[kaq]bÄ±u	telescope
jaocaqkea	remote control
jaocaqrÄ±ochao	drone
jaochuo	television
jaocua	is (being) cold
jaodoa	sends
jaofa	goes away
jaoheo	exotic
jaokaÄ±se	telegram
jaolaq	telephone
jaolaqlaq	ringtone
jaolaqsue	phones
jaome	sparse
jaomuo	is unlike
jaoshuao	turkey
jaotaq	sparse
jaotoa	SMS
jaq'acÄ±	strong acid
jaqbeÄ±	so much the case
jaqbu'eqbÄ±	demi-non-binary
jaqbulÄ±q	demi-female
jaqbunaq	demi-male
jaqchoaÄ±mute	apple product
jaqchu	mildly the case
jaqchuaqpoq	egalitarian
jaqhÄ±ao	injured
jaqhÄ±aote	injured
jaqkafe	red-eye
jaqmaÄ±chÄ±toÄ±	love-bombs
jaqnu	so much the case
jaqtuao	case to a rather
jara	runs
jarafagazala	gerenuk
jarafasÄ±u	giraffe or okapi
jaragoeq	hurdle
jaÄ±buq	smiles
jaÄ±bÄ±a	manic
jaÄ±gaq	happy
jaÄ±jaÄ±	shares the joy
jaÄ±jaÄ±kuaq	congratulates
jea	buys
jeachoaq	customer
jeadoaqpaq	shopping
jeajÄ±o	store
jeakao	receipt
jealuao	storefront
jealuoÄ±	for sale
jeaqchua	additional name
jeaqchuq	snacks on
jeaqdao	tag
jeaqdaÄ±bu	cannot increase
jeaqdÄ±akaÄ±	WriTEs
jeaqfÄ±eq	copies
jeaqfÄ±eqkuaÄ±	feels inspired
jeaqjuoÄ±	elaborates on
jeaqjÄ±qzÄ±u	hyperreal number
jeaqkuq	adds
jeaqlÄ±ao	yeast
jeaqnaby	sandwich
jeaqnao	(a) sauce
jeaqshuaq	copies
jeaqshue	dust
jeatoaÄ±	transaction
jeatÄ±aÄ±	is a package
jeaÄ±	is the same as
jedaÄ±	jedi
jeha	is* the case
jehua	is a
jehudÄ±	Jewish
jehudÄ±chuaq	Judaism
jeku	liver
jemusao	gigantic
jemy	glue
jenalÄ±q	adrenaline
jeo'aÄ±	honest
jeobo	has truth value
jeobÄ±daqmÄ±qmaÄ±raqpoqjÄ±	aphorism
jeocuaq	proposition
jeodaÄ±	proposition
jeogaÄ±	perceives
jeogÄ±	is suitable
jeogÄ±	good for one
jeohuÄ±	not good for one
jeojao	far from true
jeojeo	for sure
jeojeo	indeed
jeoketo	right whale
jeomao	also the case
jeomucuaq	property
jeomudaÄ±	property
jeomÄ±	common noun
jeopaq	feature
jeoqbo	is concave at
jeoqchuo	bowl
jeoqgÄ±u	groove
jeoqhua	pelvis
jeoru	and
jeotoa	verb
jeotoa	"atomic verb"
jeotoachue	serial
jeotoarÄ±oq	frame
jeotoÄ±	is with
jeq	identical
jeqbokuaÄ±	envies
jeqbunÄ±oq	anisodon
jeqchoq	shares
jeqchoqjuao	copyright
jeqchoqkeaÄ±juao	open licence
jeqchuaq	egalitarianism
jeqda	gender
jeqdabeo	transgender
jeqdacÄ±a	agender
jeqdajeÄ±	cisgender
jeqdakuaÄ±	gender-envies
jeqdaru'o	exhibits
jeqdashue	cisgender
jeqdasuku	transgender
jeqdy	gender
jeqgam	cube
jeqheo	is the same as
jeqjeq	identical
jeqjeqpÄ±a	identical twin
jeqjeymaÄ±	homosexual
jeqmaÄ±	gay
jeqmaÄ±	homoromantic
jeqme	uniform
jeqmoe	zen
jeqpue	isopod
jeqpÄ±a	same-sex sibling
jeqpÄ±a	twin
jeqruo	imitates
jeqseaq	homosexual
jeqtoe	cuts
jey	gender
jeyboq	cassgender
jeycuao	genderqueer
jeycÄ±a	agender
jeyfaÄ±	cisgender
jeygoÄ±saÄ±	HRT
jeyhuaqloÄ±	gender-envies
jeyleÄ±	transgender
jeymaÄ±cÄ±a	asexual
jeyrÄ±e	intergender
jeÄ±bu	different thing
jeÄ±gaÄ±	recognizes
jeÄ±heo	another
jeÄ±kuq	says exactly
jeÄ±laÄ±	logo
jeÄ±sÄ±o	identity
joagu	fortnight
joamoa	time of the week
joanhuo	weekly timetable
joaqmÄ±	king
joaÄ±jÄ±oq	finds that
joaÄ±sÄ±	on the lookout
joaÄ±taÄ±	finds
joaÄ±toa	keyword
joefoq	smartphone
joegÄ±	is a master at
joekea	smart device
joene	is
joenetoaÄ±	experience point
joga	does yoga
jogoashaha	4D chess
jogu	yogurt
joguchuaÄ±	frozen yogurt
joguru	yoghurt
joheÄ±bushuchaq	Lent
jojue	April
jojue'ahochaq	April Fool's Day
jojÄ±eq	square
jokaqhua	hirola
jokata	four
jolaqteÄ±	fourth tone
jom	demon
jonapu	on the ball
jopue	tetrapod
joq'Ä±q	primary one
joqboe	front page
joqbuchua	side name
joqcuoÄ±	satisfies with
joqdao	essence
joqhaq	entrÃ©e
joqhuacholÄ±	pillow
joqhuachuoÄ±	halter
joqhuafuaq	portrait
joqhuakuoq	skull
joqhuapue	cephalopod
joqhuasÄ±aÄ±	haemorrhage
joqkua	living room
joqkÄ±aq	head hair
joqmua	is the epitome
joqmuq	dominant hand
joqraq	chiefly
joqreaÄ±	antithesis
joqreo	hue
joqrÄ±aq	main place
joqshaqfuq	face mask
joqshaqtÄ±e	mask
joqsoÄ±	is at war with
joqteÄ±	canonical
joqtoaÄ±	protein
joqtoaÄ±huÄ±	prion
joro	sin
josekÄ±	joseki
josheaqhe	quadrupede
jotoq	tetrahedron
jotÄ±q	tetromino
jouchoq	uses
joutue	state
joÄ±gÄ±q	case instead
joÄ±lÄ±aq	is the situation
joÄ±moÄ±	considers
juabea	xenarthran
juabu	normal
juabÄ±ao	befuddled
juagÄ±q	ordinary
juahÄ±aq	typical
juajua	aberration
juakuaÄ±	feels playful
juamÄ±a	atypical
juaobue	abode
juaobuÄ±	exception
juaocha	happens lawfully
juaochebuajÄ±ao	police station
juaochÄ±aÄ±joaÄ±	prosecutes
juaochÄ±aÄ±juku	prosecutes
juaochÄ±aÄ±jÄ±aÄ±	arrests
juaochÄ±aÄ±ruaq	accuses
juaocokÄ±	legal system
juaocuegÄ±	official
juaocÄ±ao	society
juaodaÄ±	legal
juaoduebo	legal
juaodÄ±	legal
juaodÄ±u	judisprudence
juaofÄ±eqpoq	juridical person
juaohuÄ±	irregular
juaojÄ±o	court
juaokache	judge
juaokakuaq	judges
juaokakuq	judges
juaokoaq	major
juaokuÄ±	is due to law
juaome	policy
juaomea	conforms to rule
juaomÄ±eqfuaÄ±	law-interpreting
juaomÄ±eqfÄ±uq	law-interpreting
juaopoq	legal person
juaopÄ±ao	irregular
juaoruaqjoe	is a
juaorÄ±aq	court
juaoshaÄ±che	abolitionist
juaoshuaÄ±	regular
juaosoÄ±	acts against law
juaosoÄ±nuaÄ±nua	commits fraud
juaotoa	particle
juaotua	limits
juase	side effect
juateÄ±	xenomorph
juaÄ±fuq	formal clothing
juaÄ±se	serious business
jucÄ±	commits crime
jucÄ±kao	criminal record
juegu	two-month period
jueq	stirs
jueqchoarÄ±a	diphthong
jueqchÄ±	crank
jueqfuaq	jigsaw puzzle
jueqkafe	cafe frappe
jueqseaÄ±	cocktail
juju	jumps
jujukaro	springbok
juka	bounces
juku	hunts
juku	hunts
julu	incidental
july	Yule
junu	case by the way
juo	written message
juoboq	"blocks"
juoche	postman
juochedÄ±eq	sends
juocheme	postal office
juochÄ±u	mail address
juodeoq	communicates
juoheq	envelope
juojÄ±o	post office
juoqcuagÄ±	responsible
juotoq	sign
juoÄ±gÄ±	exact
juoÄ±huÄ±	inexact
juoÄ±jÄ±e	ascribes
juoÄ±koy	describes
juoÄ±kuq	describes
juoÄ±kuq	describes
juoÄ±kuÄ±	makes sense
juoÄ±kÄ±u	is characterized
juoÄ±mu	described
juoÄ±soa	explains
juoÄ±taqse	self-description
jupu	skips
juq'aÄ±doaq	Chinatown
juqbuo	is accepting of
juqca	has an effect on
juqcaha	breathes in
juqdeaÄ±	deserves
juqfa	goes to get
juqguolaÄ±	sinogram
juqguose	made in China
juqgÄ±	is good for
juqgÄ±boq	prevents
juqgÄ±tao	does
juqhuÄ±	bad
juqhuÄ±le	risky
juqjoaÄ±	on the lookout
juqkea	client machine
juqkuaq	accepts property
juqtoateÄ±	dative case
jutaq	identifies as
juy	is the same as
juÄ±bu	barely the case
juÄ±cua	is (being) warm
juÄ±duo	passes
juÄ±fa	passes
juÄ±koÄ±	passes
juÄ±me	dense
juÄ±me	dense
juÄ±mlaÄ±	Zhuyin
juÄ±mlaÄ±cha	Zhuyin
juÄ±peo	passes
juÄ±shaÄ±	leaves behind
juÄ±taq	dense
jyq	is common with
jÄ±abuaq	forgets to do
jÄ±adÄ±o	today
jÄ±adÄ±u	futurology
jÄ±ajoa	next week
jÄ±ajue	next month
jÄ±akoe	plans to do
jÄ±akoekao	to-do list
jÄ±akuaÄ±	restless
jÄ±aleo	plans to do
jÄ±amoaq	envisions
jÄ±anÄ±aq	next year
jÄ±ao'aÄ±	sacred
jÄ±ao'eÄ±	holy cow
jÄ±aodeoq	prays
jÄ±aodoÄ±	worships
jÄ±aodÄ±u	theology
jÄ±aogoafuaq	idol
jÄ±aogÄ±	(event) is pious
jÄ±aokeq	gold
jÄ±aokuq	preaches
jÄ±aokuqche	priest
jÄ±aolua	myth
jÄ±aonulÄ±ruaÄ±	Christ
jÄ±aoraq	divine
jÄ±aq'aobÄ±	imaginary world
jÄ±aqbÄ±atue	pandemic
jÄ±aqfao	end of the world
jÄ±aqheoq	equator
jÄ±aqjeo	is true in world
jÄ±aqjÄ±q	exists in world
jÄ±aqkoaÄ±	World Wide Web
jÄ±aqkoaÄ±luaqchuo	web browser game
jÄ±aqkoaÄ±luaqmu	web browser game
jÄ±aqkoaÄ±rÄ±aq	website
jÄ±aqkÄ±oq	globe
jÄ±aqloqtue	climate change
jÄ±ataÄ±	remembers to do
jÄ±aÄ±deq	prehensile
jÄ±aÄ±doa	hands
jÄ±aÄ±foaq	is cuddly with
jÄ±aÄ±gue	hook
jÄ±aÄ±juq	captures
jÄ±aÄ±koÄ±my	ladder
jÄ±aÄ±my	handle
jÄ±aÄ±nÄ±oq	canine teeth
jÄ±aÄ±paq	handle
jÄ±aÄ±se	handful
jÄ±aÄ±taÄ±	catches
jÄ±dao	fennec
jÄ±egÄ±	well-respected
jÄ±ehuÄ±	ill-respected
jÄ±ekÄ±u	subjective
jÄ±ekÄ±ugÄ±q	objective
jÄ±elu	subjective
jÄ±emÄ±a	common opinion
jÄ±eqbo	pointy
jÄ±eqguese	angle
jÄ±fuaq	solo selfie
jÄ±hao	us
jÄ±jeÄ±	me
jÄ±jÄ±	two of us
jÄ±jÄ±e	how I deem
jÄ±ko	World Wide Web
jÄ±kokÄ±qme	web series
jÄ±korÄ±	website
jÄ±korÄ±aq	website
jÄ±me	us
jÄ±mnuo	naps
jÄ±obuÄ±	outdoors
jÄ±obÄ±u	chimney
jÄ±odÄ±u	architecture
jÄ±ofuaq	ground plan
jÄ±ofÄ±eqche	architect
jÄ±oluko	dog
jÄ±onÄ±e	indoors
jÄ±opuefuq	slipper
jÄ±oqdaotoq	spreadsheet
jÄ±oqdÄ±u	mathematics
jÄ±oqfÄ±eq	devises
jÄ±oqgaq	workshops
jÄ±oqjuao	program
jÄ±oqjuaobeo	hack
jÄ±oqjuaogoÄ±	debugs program
jÄ±oqkea	computer
jÄ±oqkea	calculator
jÄ±oqseÄ±	mathematical
jÄ±oqtaÄ±	calculates that
jÄ±otanÄ±	pillar
jÄ±pa	satisfied by me
jÄ±qbÄ±ao	has psychosis
jÄ±qchoq	uses
jÄ±qchuaq	existentialism
jÄ±qcuao	transcendent
jÄ±qhako	bear
jÄ±qhaÄ±	already exists
jÄ±qjeo	literally true
jÄ±qjeo	legitimately
jÄ±qjÄ±ao	True God
jÄ±qjÄ±aq	real world
jÄ±qjÄ±aq	reality
jÄ±qkaq	real
jÄ±qlua	true story
jÄ±qluÄ±	extinct
jÄ±qnaÄ±	extant
jÄ±qsho	comes true
jÄ±qshÄ±	entity
jÄ±qtue	fact
jÄ±qtuq	universe
jÄ±qtÄ±ao	accurate
jÄ±qzÄ±	jeans
jÄ±qzÄ±u	real number
jÄ±toa	pronoun
jÄ±togÄ±	clue
jÄ±ucoaq	domesticated
jÄ±ucupÄ±	endometrium
jÄ±udoa	gives birth
jÄ±uhaqhua	placenta
jÄ±uhua	womb
jÄ±uhuacupÄ±	endometrium
jÄ±uhuacÄ±u	menstruates
jÄ±ujeq	twin
jÄ±ujÄ±a	embryo
jÄ±use	litter
jÄ±ushoe	bears
jÄ±usÄ±ao	births
jÄ±utua	bears
kabe	hoe
kabeta	hoes
kabetao	hoes
kabo	carbon
kabokaÄ±chuo	pencil
kabosaÄ±	is
kacanha	chestnut tree
kadeoq	declares
kadeoq	declares
kafaq	hereby the case
kafepuo	coffee grounds
kafesaÄ±	caffeine
kafyka'aÄ±	Kafkaesque
kafykyhese	Kafkaesque
kagajeq	is just like
kahahua	throat
kahÄ±a	great
kajÄ±a	swears oath
kakao	cacao
kakaofaseo	cocoa bean
kakaopuo	cocoa powder
kakoe	decides
kakotosÄ±u	cactus
kala	cringe
kalu	hereby the case
kalÄ±um	potassium
kamaqbe	pie chart
kamechaÄ±	Camellia tea
kamoho	chamois
kampa	camps
kampaloe	campfire
kamparÄ±aq	campsite
kanoa	canoe
kanÄ±	rabbit
kanÄ±nueq	rabbit meat
kaochÄ±o	logs into
kaodoa	stores
kaodoakÄ±u	is
kaodoakÄ±ubulureÄ±feoq	BD-R
kaodoakÄ±udÄ±bÄ±dÄ±	DVD-R
kaodoakÄ±usÄ±dÄ±	CD-R
kaodÄ±eq	uploads
kaojuq	downloads
kaokaÄ±che	scribe
kaokÄ±um	calcium
kaolaÄ±	file
kaonua	reads
kaonuakÄ±u	is
kaopeq	paper document
kaoshaÄ±	logs out
kaosho	signs up
kapacosoa	abets
kapasasaÄ±	cotton
kapasaÄ±	cotton
kapu	head
kaqbo	has appearance
kaqbuby	has an inviting
kaqbÄ±oÄ±	gets spotted
kaqchuao	window
kaqcÄ±a	blind
kaqdao	view
kaqdeq	can see
kaqdeqbu	blind
kaqdeqcÄ±a	blind
kaqdÄ±um	scandium
kaqfoa	looks
kaqfÄ±e	visually ugly
kaqga	bites
kaqgaÄ±kea	film camera
kaqgaÄ±kÄ±u	visible
kaqgaÄ±taqchuo	mirror
kaqge	has appearance
kaqhuacÄ±use	rheum
kaqhuapoke	Ross seal
kaqhuÄ±	looks bad
kaqjua	looks weird
kaqjÄ±	kanji
kaqjÄ±	congee
kaqmuoÄ±	rolls their eyes
kaqnuao	brow
kaqnuaokÄ±aq	eyebrow
kaqpoarÄ±a	blinks
kaqpuao	lacks definition
kaqrÄ±	Welsh
kaqrÄ±gua	Wales
kaqse	look
kaqshue	stares at
kaqshÄ±a	lens
kaqshÄ±ashÄ±	monocle
kaqsÄ±pÄ±o	calcite
kaqsÄ±u	visually similar
kaqtÄ±enua	opens his
karama	karma
karasere	European hornet
karate	karate
kareq	rattles
karo	goat
karolo	goral
karonuÄ±sÄ±u	mouse-deer
karote	goated.
karotoq	carrot
karÄ±	curry
kasha	offers
kashalo	sperm whale
kasuarÄ±	cassowary
kasÄ±	nut
kata	card
katame	deck of cards
katana	katana
kato	cat
katochea	cat-ears hat
katojaÄ±choa	purrs
katopuenuÄ±	red panda
katopuenuÄ±sÄ±u	ailurid
katosoÄ±	catfights with
katosÄ±u	cat
kaze	beat
kazeguo	beat
kazu	kazoo
kaÄ±	records
kaÄ±ce	article
kaÄ±che	scribe
kaÄ±choÄ±my	pencil sharpener
kaÄ±doa	posts message
kaÄ±fÄ±eq	writes
kaÄ±fÄ±eq	writes
kaÄ±fÄ±eqche	writer
kaÄ±gÄ±q	erases
kaÄ±gÄ±qchuo	eraser
kaÄ±kabo	pencil
kaÄ±kea	keyboard
kaÄ±keatoaÄ±	key
kaÄ±kue	notebook
kaÄ±kuq	writes
kaÄ±kÄ±q	cartoon
kaÄ±kÄ±u	writable
kaÄ±muoq	ink
kaÄ±mÄ±eq	spells out
kaÄ±nao	ink
kaÄ±naocea	ink sac
kaÄ±pume	archive
kaÄ±pÄ±o	graphite
kaÄ±rÄ±oq	font
kaÄ±sebe	stub article
kaÄ±sekoaq	final draft
kaÄ±shea	blank
kaÄ±sho	print
kaÄ±toaq	written language
kaÄ±toaÄ±	written stroke
kaÄ±toq	whiteboard
keacaq	operates
keafuaq	screenshot
keakaÄ±	types text
keakaÄ±teÄ±	keyboard layout
keakue	webpage
keakuq	texts
keapoq	robot
keaqcuaÄ±	marinated
keaqkushu	brined cucumber
keaqkusu	pickle
keaqloeq	pickled
keaqsaÄ±	salt
keaqsaÄ±heq	salt shaker
keazu	machine language
keaÄ±laÄ±	is a ticket
keaÄ±leÄ±	is privileged in
kebo'aqshe	hinny
kebogama	huemul or taruca
kebÄ±q	kelvin
kechapy	ketchup
keho	Hell
keleo	clitoris
kena	stork
keneÄ±da	cnidarian
keno	horn
kenobonuÄ±	pudu
kenobosa	European hornet
keobusuaojÄ±ejÄ±	never.mind
keopÄ±	quasi-copy
keoruaq	retorts, objects
keoÄ±	talks
kepa	onion
keqjuo	shitpost
keqkaju	kinkajou
keqkea	shitter.
keqkuaÄ±	has to poop
keqnoa	constipated
keqnÄ±u	weed
keqpueq	fucks up
kera	brain
kere	scrotum
kerÄ±oq	is a type of
kesha	clown
keto	cetacean
kezu	vinegar
kezute	pickled
kezutua	pickles
keÄ±ky	cake. ğŸ‚ğŸ°ğŸ§
ko	is
ko	is
ko'aÄ±	the internet
ko'aÄ±coe	links
ko'aÄ±coe	links
ko'y	talks
koa'aÄ±	minty
koacuaÄ±	dank
koafurÄ±	shivers
koahako	polar bear
koakafe	cold brew coffee
koakea	air conditioning
koakuakea	air conditioner
koaloy	â€œrawâ€
koalÄ±e	feels cold
koamoe	cool
koamuao	Aspen tree
koaqjeaq	grows
koarÄ±okea	air conditioning
koatue	cold spell
koatÄ±	coati
koatÄ±nuÄ±	mountain coati
koaÄ±fachuo	web browser
koaÄ±noaqchuo	web browser
kobala	cobalt
kobodo	Kobold
kobÄ±de	COVID
kobÄ±deheÄ±neÄ±	COVID-19
koche	automobile
kocy	goo
kocytÄ±e	slimy
koe	chooses
koe	chooses
koe	chooses
koecachuaq	determinism
koecaÄ±	is confident
koechuaq	existentialism
koekuaq	votes
koekÄ±u	available
koenoa	is at a dilemma
koerue	is vacillating
koese	was chosen
koesheÄ±	has a choice
koeteoq	closed question
koetoÄ±	selects
kofÄ±dyheÄ±neÄ±bÄ±a	has COVID-19
koja	captures
kojuao	ko rule
koko	related
kokozeo	coconut
kolakasÄ±	kola nut
kolera	cholera
komodobarala	Komodo dragon
komorebÄ±	is komorebi
konÄ±	European rabbit
konÄ±ly	bnuuy
konÄ±q	European rabbit
kopuq	ordered group
kopÄ±o	scorpion
kopÄ±pagechÄ±	copypasta
kopÄ±ruo	mimics
koqchoacha	creaky voice
koqfetÄ±	confetti
koqgonÄ±	hartebeest
koqlaq	creaking
koqpu	computer
koqpue	armadillo
koqputo	computer
koqputoq	computer
koqro	cartilage
koqto	account
koqtofuaq	profile picture
korotu	spotted hyena
koruo	raven
korÄ±o	hazel
koselo	hazel
kosÄ±	= cos
kotua	sorts
koychue	exchange
koyhao	interacts with
koyrÄ±aq	chatroom
koyrÄ±oq	social identity
koÄ±beaq	walking stick
koÄ±buaq	trips
koÄ±ceaq	hoof
koÄ±ceaqbo	ungulate
koÄ±fa	goes
koÄ±hua	leg
koÄ±soÄ±che	infantry soldier
koê¡am	clock
ku'aÄ±	orientation
ku'aÄ±	is
kuajeq	roommate
kuane	roomful
kuaokuq	blogs
kuaomÄ±o	colour azure
kuaomÄ±o	of the colour
kuaopÄ±o	turquoise
kuaqba	challenges
kuaqgÄ±q	represses
kuaqhuÄ±	deceitfully
kuaqkuq	announces
kuaqtoa	interjection
kuaqtoaÄ±	sentence
kuaqza	Kwanzaa
kuasu	kvass
kuaÄ±boaÄ±le	impulsive
kuaÄ±ca	tempting
kuaÄ±caq	controls
kuaÄ±ge	inspiration
kuaÄ±kuaÄ±	insatiable
kuaÄ±luaq	teases
kuaÄ±ruo(he)	impulsive
kuaÄ±shaÄ±	gets bored of
kuaÄ±tuagezÄ±a	suggests
kubakafe	cafe cubano
kubo	egg
kubobao	egg white
kuboboe	omelette
kubolue	egg yolk
kubopÄ±u	eggshell
kucho	gelatin
kudote	converse
kueboe	book page
kuecea	book-bag
kueche	librarian
kuefua	bookcase
kuejÄ±o	library
kuejÄ±oqkea	laptop
kuekao	book
kuekea	printing press
kueme	book series
kuemuÄ±	definition
kueneotoq	bookshelf
kuepo	vagina
kueqbeq	heap
kueqboche	collector
kueqbÄ±u	funnel
kueqgÄ±q	disperse
kueqme	cluster
kueqse	crowd
kueqtuapua	collects
kuetÄ±e	book cover
kugu	sneaking
kugupoq	sneaky person
kuha	cheese
kuhachochÄ±	nachos
kuhachÄ±kyq	nacho
kuhapoaÄ±	omelette
kuku	typical cuckoo
kukÄ±	cookie
kulo	mosquito
kum	is
kumÄ±	worm
kunechoa	barks
kunehupÄ±	crab-eating fox
kunemuse	prairie dog
kunesÄ±u	canid
kuobao	black-and-white
kuochaÄ±	black tea
kuohuohua	caracal
kuojeoq	black hole
kuoketo	humpack whale
kuoluaq	black player
kuopo	black playerâ€™s
kuoqbo	vertebrate
kuoqbue	shell
kuoqbuq	beak
kuoqchu	bone marrow
kuoqhuna	cartilage
kuoqleoq	shell
kuoqme	skeleton
kuoqnhuo	ribcage
kuoqnÄ±aÄ±	vertebrate
kuoqpuo	bone meal
kuoqpÄ±u	shell
kuoqsaÄ±	bone
kuorÄ±ba	blackcurrant
kuoshuao	crow
kuosoq	neck
kuoÄ±choaÄ±	is discounted
kuoÄ±mea	minority
kupÄ±	carp
kuqbuaq	means to say
kuqca	remarkable
kuqcechue	chatroom thread
kuqceme	chat server
kuqchedu	tells lie
kuqcheu	tells lie
kuqchey	tells lie
kuqgÄ±aÄ±kaÄ±	carves writing
kuqha	as they say
kuqhuÄ±	tells the lie
kuqhÄ±ao	insults
kuqjaq	rants
kuqkaÄ±	transcribes text
kuqkaÄ±	writes
kuqkaÄ±se	transcript
kuqkÄ±u	remarkable
kuqmuo	done talking
kuqpoaqse	fragment
kuqpuao	speech bubble
kuraÄ±	topic
kuru	hunts down
kurum	copper
kurÄ±nÄ±u	berry bush
kushu	cucumber
kushu	cuddles
kushumy	plushie
kusu	squash
kusuchaq	Halloween
kusukuaÄ±	squishes
kusunÄ±u	plant
kusÄ±maqse	kusimanse
kuytao	pleads
kuzu	kudzu
kuÄ±	thus the case
kuÄ±deoq	credits
kuÄ±gÄ±qcÄ±a	pointless
kuÄ±kuq	explains
kuÄ±mu	case
kuÄ±ne	predetermined
kuÄ±ruaq	justifies
kuÄ±sheatoa	a-priori word
kuÄ±tao	motivated
kuÄ±tua	justifies
kÄ±abeq	itch
kÄ±aca	perceived as red
kÄ±acuao	infrared color
kÄ±age	red
kÄ±akune	dhole
kÄ±aloa	spectrum
kÄ±aloha	copper
kÄ±amÄ±ao	lunar eclipse
kÄ±anaokusu	watermelon
kÄ±aoche	gatekeeper
kÄ±aogÄ±u	corridor
kÄ±aojÄ±aÄ±paq	door handle
kÄ±aosÄ±u	thyroid gland
kÄ±aotoqcÄ±oq	doorknob
kÄ±apÄ±o	brick
kÄ±aqbuaÄ±	has long hair
kÄ±aqche	barber
kÄ±aqchuo	comb or brush
kÄ±aqcÄ±a	hairless
kÄ±aqdoq	has short hair
kÄ±aqkenobo	tufted deer
kÄ±aqketea	baleen whale
kÄ±aqme	patch of hairs
kÄ±aqnua	cuts
kÄ±aqnÄ±u	grass
kÄ±aqsÄ±qsaÄ±	shampoo
kÄ±aqteÄ±	hairstyle
kÄ±aqtoe	cuts hair
kÄ±arÄ±ba	redcurrant
kÄ±ashao	flushes
kÄ±ashaq	blushes
kÄ±aÄ±he	carer
kÄ±boy	keyboard
kÄ±bu	is impervious
kÄ±bumÄ±etoaÄ±	immunocyte
kÄ±butoaÄ±	antibody
kÄ±butua	antigen
kÄ±bÄ±	kiwi fruit
kÄ±do	copper
kÄ±echaq	Thanksgiving
kÄ±edoa	rewards
kÄ±egÄ±q	feels resentment
kÄ±ejuq	gets reward
kÄ±ejuqtÄ±ao	merits
kÄ±eqca	disgusting
kÄ±eqgueca	cringy
kÄ±eÄ±	ice
kÄ±eÄ±gam	ice cube
kÄ±eÄ±koÄ±	ice-skates
kÄ±ky	feels bad
kÄ±lo	kilogram
kÄ±lo	kilogram
kÄ±lo	is
kÄ±mluaq	roleplays as
kÄ±mÄ±	bedbug
kÄ±no	movie
kÄ±okÄ±laÄ±	parentheses
kÄ±olaÄ±	left parenthesis
kÄ±oq'aÄ±	rounded
kÄ±oqbÄ±u	cylinder
kÄ±oqgupaq	hemisphere
kÄ±oqgÄ±o	lantern
kÄ±oqjoqhua	pilot whale
kÄ±oqjÄ±oqchuo	abacus
kÄ±oqmuoÄ±	torus
kÄ±oqmuoÄ±haq	bagel
kÄ±oqseu	number Ï€
kÄ±oqsuoÄ±	marbellous
kÄ±oqzÄ±u	number Ï€
kÄ±oraq	parenthetical
kÄ±oty	kilt
kÄ±pu	quipu
kÄ±qchuao	screen
kÄ±qchue	TV series
kÄ±qgaÄ±	watches a movie
kÄ±qkea	video screen
kÄ±qluaq	plays videogame
kÄ±qme	show
kÄ±qsÄ±eme	video series
kÄ±qtoq	video screen
kÄ±ro	jerk
kÄ±rÄ±	cute
kÄ±rÄ±cojÄ±u	Christmas
kÄ±rÄ±cokoko	Christian
kÄ±rÄ±sochuaq	Christianity
kÄ±rÄ±sochuaqkue	bible
kÄ±rÄ±sytochuaq	Christianity
kÄ±rÄ±sytochuaqkue	bible
kÄ±tÄ±	fur
kÄ±tÄ±toe	shaves
kÄ±zÄ±a	emits a click
labÄ±	lion
labÄ±bodoa	thrown
ladoq	lad
lago	lagomorph
lagyba'ome	Lag BaOmer
lalea	tulip
lama	llama
lamÄ±a	lamia
laocaÄ±	patient
laocaÄ±cÄ±a	impatient
laochaq	is the eve of
laocheo	in a deadlock
laochoa	stutters
laofabeta	alphabet
laofey	excited
laojaÄ±	looks forward
laojoe	patient
laonÄ±eq	impatient
laorue	impatient
laotao	ditzes
lapaqdÄ±u	logic
lapaqjÄ±oq	infers
lapaqmoÄ±	infers
laqbÄ±o	bell
laqchue	melody
laqchuo	horn
laqcÄ±a	silent
laqdaqchuo	timer
laqdÄ±eq	podcast
laqgeabÄ±a	has tinnitus
laqgeateÄ±laÄ±	tone mark
laqgeateÄ±zu	tonal language
laqguao	tuning fork
laqjuo	podcast
laqkea	speaker
laqkÄ±oq	jingly bell
laqleaqdÄ±u	phonotactics
laqleoq	earplugs
laqluoq	harmony
laqme	chord
laqnuoq	echo
laqpaq	gets this bread
laqrua	orchid
laqruaq	beeps
laqruoq	monotone
laqshuaq	emits sound
laqshuaqdÄ±u	phonics
laqsy	salmon
laqteÄ±zu	tonal language
laqtoa	onomatopoeia
laqtoaÄ±	musical note
laqzÄ±a	emits a sound
laraÄ±	proposition
laruq	larynx
laruqbeq	Adam's apple
lasa	curls up
lasatuaq	blackbuck
latoa	complementizer
lazanha	lasagna
lazaqnha	lasagna
lazulÄ±pÄ±o	lapis lazuli
laÄ±bala	garbled text
laÄ±baÄ±	spells out
laÄ±boe	flag
laÄ±chea	diacritic
laÄ±chuekao	plain text file
laÄ±cÄ±use	hormone
laÄ±doa	assigns
laÄ±dÄ±eq	signs
laÄ±gÄ±u	line of text
laÄ±haqgÄ±ly	Korean character
laÄ±kaÄ±	spells out
laÄ±koekea	keyboard
laÄ±lea	calligraphy
laÄ±lua	symbolic story
laÄ±nÄ±aÄ±	allegory
laÄ±paq	diacritic
laÄ±rÄ±oÄ±	label
laÄ±saÄ±	hormone
laÄ±shÄ±	Christ
laÄ±sucao	Christmas
laÄ±suchuaq	Christianity
laÄ±sue	cues
laÄ±sujÄ±uchaq	Christmas
laÄ±sujÄ±ulaochaq	Christmas Eve
laÄ±sunÄ±qjÄ±uchaq	Easter
laÄ±sÄ±emekao	plain text file
laÄ±sÄ±o	is a metaphor
laÄ±teÄ±	letterform
laÄ±teÄ±me	font or typeface
laÄ±tÄ±q	Latin
leabo	artistic
leachue	serialized
leagÄ±	of good quality
leagÄ±kuaÄ±	perfectionist
leajÄ±o	art museum
leaqbua	neighbor
leaqbueme	neighborhood
leaqjÄ±ome	neighborhood
leata	(an) aesthetic
leatÄ±qme	mosaic
lecagÄ±	conducive
lecÄ±a	impossible
ledua	guesses
legÄ±q	improbable
leje	cork
lejeheÄ±ga	cork oak
lemoq	lemon
lemuo	sure to occur
lemuresÄ±u	lemur
lena	dress
leokaÄ±se	essay
leoleo	keeps trying
leoq(tao)kuaÄ±	defensive
leoqbosÄ±u	house centipede
leoqchea	helmet
leoqfuq	armor
leoqheaqsÄ±u	house centipede
leoqhÄ±esÄ±u	house centipede
leoqmy	shield
leoqrÄ±aq	shelter
leoqtao	protects
leoqtemoe	feels safe
leoqtÄ±e	armor
leoqtÄ±q	scute
leoshaÄ±cÄ±a	is persistent
leposÄ±u	rabbit
leqfuo	licks
leqfurÄ±laq	trill
leqhuaÄ±	licks
leqjÄ±eqcha	apical
leqlÄ±acha	lateral
leqtoqcha	laminal
lera	liquid
leÄ±	rare
leÄ±muÄ±	odd
leÄ±suoÄ±	is exclusive
loachue	forum
loahÄ±upÄ±o	amethyst
loakepa	red onion
loanÄ±u	violet
loaqdea	spanks
loaqjeoq	asscrack
loaqmoe	feels assertive
loaÄ±baga	pumps
loaÄ±bÄ±a	has the flu
loaÄ±bÄ±u	spout
loaÄ±daÄ±	fluid
loaÄ±daÄ±tuao	semiliquid
loaÄ±fua	fountain
loaÄ±fuÄ±	runny
loaÄ±fuÄ±saÄ±	lubricant
loaÄ±goaÄ±	slips
loaÄ±hua	heart
loaÄ±hua	heart
loaÄ±kea	pump
loaÄ±laq	approximant
loaÄ±laq	continuant
loaÄ±luao	spout
loaÄ±meoq	viscous
loaÄ±noa	viscous
loaÄ±pÄ±o	magma
loaÄ±rÄ±aÄ±	fountain
loaÄ±rÄ±o(saÄ±)	is
loaÄ±shua	pours onto
loaÄ±shuatua	pours
loaÄ±suaÄ±	runny
loaÄ±toa	danmaku comment
loaÄ±tua	lung
loaÄ±tuacha	pulmonic
loebeaq	candle or torch
loebÄ±u	chimney
loebÄ±utuaÄ±	pyrosome
loechuo	lighter
loefa	moth
loefua	wood-burner
loehaq	fuel
loehÄ±eqchuo	flame thrower
loekÄ±a	crimson
loekÄ±oq	fireball
loeleq	flame
loeloy	roasted
loemeÄ±	volcano
loemeÄ±pÄ±o	basalt
loenao	lava
loepoaÄ±	ember
loepuao	smoke
loepuaobÄ±u	chimney
loepÄ±o	coal
loepÄ±o	flint
loepÄ±otuÄ±	dragon
loeq	cooks
loereobo	bullfinch
loerua	firework
loerÄ±aq	fireplace
loeshuao	phoenix
loeshÄ±a	obsidian
loetue	fire
lofaÄ±fuaq	lo-fi artwork
lofaÄ±gÄ±aq	lo-fi music
logalaq	Loglan language
logo	logo
loha	metal
lohachuoÄ±	wire
lohagupu	rusts
lohagÄ±aq	metal
lohakoaÄ±	chainmail
lohamechuoÄ±	cable
lohatÄ±eq	railroad
lohaÄ±	blÃ¥haj
lojÄ±baqpoq	lojbanist
lojÄ±bo	Lojbanic
lojÄ±bozu	Lojban language
loqcÄ±a	raw
loqdekÄ±	thermometer
loqduÄ±	burns
loqhaq	cooked
loqhaq	brewed food
loqhaqbaÄ±	brews food
loqhÄ±ao	burns
loqkoa	lukewarm
loqkune	hot-dog
loqlaq	Loglan language
loqloaÄ±daÄ±	molten
loqloeq	cooked with heat
loqluÄ±	cooked
loqlÄ±e	feels hot
loqne	temperature
loqnechuo	thermometer
loqpuefuq	slipper
loqsa	jaguar
loqsaosa	hot sauce
loqtue	heat wave
loqzÄ±a	radiates heat
lorÄ±	Lohri
lorÄ±q	chlorine
loycÄ±a	raw
loynueq	prepared meat
loÄ±baq	Lojban language
loÄ±chuaq	systemic
loÄ±cua	avenges property
loÄ±fea	puts up with
loÄ±seaq	hatefucks
luakoaq	koan
luakuÄ±	has moral
luaofuo	kisses
luaojÄ±aÄ±	kisses
luaokÄ±aq	mustache
luaokÄ±aqketea	baleen whale
luaolaq	labial consonant
luaoleoq	lip balm
luaonhou	kisses
luaoroÄ±nÄ±oq	labiodental
luaosaÄ±	lipstick
luaotoÄ±	kisses
luaotuaq	beak
luaq'uo	is a round
luaqcaqchuo	game controller
luaqcha	game mode
luaqcha	play gamemode
luaqche	occupational
luaqchukao	save file
luaqchuo	toy
luaqcuaq	game
luaqcÄ±toq	die
luaqduogÄ±aqme	suite
luaqfÄ±eq	tinkers
luaqgaq	plays with
luaqguo	game
luaqgÄ±	entertaining
luaqhea	is a stage
luaqjuao	rule of a game
luaqjuao	game
luaqkata	playing card
luaqkoeduaÄ±	in zugzwang
luaqkÄ±oq	marble
luaqkÄ±q	videogame
luaqmoe	has fun
luaqmu	game
luaqmy	toy
luaqne	score in a game
luaqne	game variable
luaqne	has score
luaqpoq	piece
luaqse	game played
luaqtao	play(s) game
luaqtaÄ±	wins in game
luaqtoaÄ±	game turn
luaqtue	(game) position
luaruaq	tells story
luaruco	tells story
luaruo	acts out
luaruoche	actor
luasÄ±	listens to
luaÄ±che	humorist
luaÄ±cuaq	gag
luaÄ±de	whimsical
luaÄ±kuq	tells joke
luaÄ±kuqse	joke
luaÄ±moe	amused
luaÄ±ruo	jokester
luaÄ±se	funny thing
luaÄ±taose	joke deed
luce	ulcer
lucu	game
luehepete	yellow mongoose
lueqce	server
lueqduaÄ±	slave
lueqjuq	client
lueqkea	server
lueqluaq	subs
lueqmuce	client
luerÄ±q	of color
luesaÄ±	sulfur
lufÄ±	is
lujÄ±oq	infers
luko	dog
lukuq	says
lukuÄ±jÄ±oq	infers
lukuÄ±moÄ±	infers
lulu	french-kisses
lulu	french-kisses
luocheo	family
luochua	family name
luojeq	family member
luomea	family member
luoqbeaq	scales
luoqkea	balance scale
luoqruo	and
luoqtua	moderates
luoraq	related
luoshÄ±	family member
luoÄ±	is a target
luq'uo	round
luqbu	waist
luqdÄ±u	mindfulness
luqke	lynx
luqnao	pond
lurÄ±aÄ±	justifies
lusha	slips
lushaca	slippery
lutoame	relative clause
luÄ±gÄ±q	going
luÄ±sho	reaches
luÄ±sho	passes
lÄ±adao	tag
lÄ±ahua	side
lÄ±ajeo	parallel
lÄ±akoÄ±	crab-walks
lÄ±amÄ±	bishop
lÄ±ao'aka	hypha
lÄ±aodÄ±u	mycology
lÄ±aojeaq	leavens
lÄ±aolaÄ±	lichen
lÄ±apaq	side
lÄ±apeo	passes
lÄ±area	side
lÄ±aÄ±	floats
lÄ±aÄ±hua	fin
lÄ±aÄ±hua	fine
lÄ±aÄ±huapue	pinniped
lÄ±aÄ±muo	in flux
lÄ±aÄ±rÄ±aq	swimming pool
lÄ±aÄ±sheq	diving knife
lÄ±aÄ±shoaÄ±	fin
lÄ±aÄ±shoaÄ±	fine
lÄ±bo	has property
lÄ±cy	Chinese
lÄ±da	Litha
lÄ±efa	explores
lÄ±egÄ±	enjoyable
lÄ±ekao	diary
lÄ±ekuaÄ±	craves adventure
lÄ±eluoq	is used
lÄ±eqgoa	corner
lÄ±eqnua	wedges
lÄ±ezao	is accustomed
lÄ±la	lilac
lÄ±m	understands
lÄ±na	clay
lÄ±nagam	brick
lÄ±ofeo	west direction
lÄ±omuq	left hand
lÄ±omuqpoq	left-handed
lÄ±opaq	left part
lÄ±q'a	lass
lÄ±q'aÄ±	feminine
lÄ±q'aÄ±	feminine
lÄ±qbaka	cow
lÄ±qcÄ±o	adolescent girl
lÄ±qfu	daughter
lÄ±qguoso	cow
lÄ±qhupÄ±	vixen
lÄ±qhupÄ±seo	fox wife
lÄ±qkata	queen
lÄ±qky	link
lÄ±qlaÄ±	female sign â™€
lÄ±qnaq	androgynous
lÄ±qpa	lymph
lÄ±qpoaÄ±	ovum
lÄ±qruo	feminine
lÄ±qsaq	Asiatic linsang
lÄ±qsaqsuÄ±	prionodontid
lÄ±shu	Chinese
lÄ±tÄ±um	lithium
lÄ±uloha	aluminium
lÄ±uloy	lightly fried
lÄ±uney	abashed
lÄ±ureo	pastel-colored
lÄ±usoqloha	lithium
ma'Ä±	romantic
mabea	magic wand
mabo	has truth value
mabula	execrable
mace	mates with
macha	matcha
machachaÄ±	matcha tea
maduepojÄ±pÄ±o	amirite
madÄ±kata	tarot
madÄ±katame	tarot
mago	olive
magonulÄ±	olive oil
magopÄ±o	olivine
magÄ±nabÄ±	spiraculous.
maheo	differs
mahoganÄ±	mahogany tree
majoneze	mayonnaise
majÄ±	magic itself
majÄ±beaq	magic wand
majÄ±bo	enchanted
majÄ±che	magician
majÄ±jeo	happens by magic
majÄ±koe	casts
majÄ±laÄ±	sigil
majÄ±lÄ±qdeo	magical girl
majÄ±my	magical trinket
majÄ±nao	potion
majÄ±peq	magical scroll
majÄ±poq	magician
majÄ±soaÄ±	magical beam
majÄ±tao	happens by magic
majÄ±toa	magical word
makasÄ±q	moccasin
malahÄ±	angel
mame	breast
mana	mana
manaopÄ±o	agate
manha	believes in
manulu	Pallas's cat
maodaq	peony
maojanaby	banana bread
maojanam	banana bread
maojeo	also the case
maojÄ±e	projects
maomao	meow-meow cat
maomao	meows
maqga	manga
maqgane	manganese
maqgo	mango
maqkaÄ±heaq	mango tree
maqnesÄ±oq	magnesium
maqnesÄ±um	magnesium
maqnÄ±	is this
maqpa	satisfied by it
maqraÄ±	inanimate
mara	fluffy
maro	marble
maroloha	calcium
marÄ±huana	marihuana
marÄ±kÄ±	maize plant
marÄ±kÄ±	corn
marÄ±kÄ±beaq	ear of corn
marÄ±kÄ±rua	cornflower
masame	brocket deer
masapaq	marzipan
masua	yawns
mateoq	yes-no question
matu	honey
matumusela	tayra
matuseaÄ±	mead
matuzu	marten
maza'asyna	Zoroastrian
mazÄ±	potato
mazÄ±beaq	french fries
mazÄ±boe	potato chips
mazÄ±cheÄ±	french fries
mazÄ±u	Boolean value
maÄ±coeq	polycule
maÄ±duÄ±	love-bombs
maÄ±jÄ±aÄ±	hugs
maÄ±loha	magnet
maÄ±lua	romance
maÄ±mu	beloved
maÄ±nÄ±kyrafy	minecraft
maÄ±paÄ±chaq	Valentineâ€™s Day
maÄ±suq	you, my love
meadÄ±u	plural logic
meahey	copy
meakuqse	mention(ing)
meame	set
meamedÄ±u	set theory
meametuq	power set
meamuo	complete
meamÄ±a	varied
meamÄ±q	infinitely many
meaqboe	sail
meaqbÄ±a	seasick
meaqtÄ±eq	canal
meashoe	admits
measuao	special
meazua	excludes
meaÄ±	celestial object
mechakucha	absurd
mechuoÄ±	string
mechÄ±aqhua	collective mind
medu	mead
medue	valid
medÄ±teÄ±	meditates
mehÄ±konuaÄ±	Mexican peso
mejÄ±	us
mejÄ±o	museum
meka	crane
mekajÄ±ao	deus ex machina
mekorua	poppy
meloq	apple tree
meloq	melon
melÄ±	true badger
meme	meme
memÄ±	proper noun
meneuchu	arithmetic mean
menu	menu
menÄ±sÄ±u	pangolin
meobÄ±a	depressed
meoca	saddens
meojaq	feels sorrow
meoqca	slows
meoqmÄ±	pawn
meozu	Lojban
mepaq	is an element
mepoaq	splits
mereuchu	geometric mean
merÄ±eqda	afternoon
mesho	fusion
mesofa	sectional sofa
mesÄ±q	brass
meta	one meter
meteÄ±	posture
meÄ±deÄ±	SOSâ€™s
meÄ±dofuqme	maid outfit
meÄ±guaq	mountain range
meÄ±gÄ±u	mountain range
meÄ±haranÄ±ka	mountain arnica
meÄ±karo	rhebok
meÄ±lu	email
meÄ±ly	apple tree
meÄ±me	mountain range
meÄ±me	heap
meÄ±meÄ±	mountain range
meÄ±moa	bump
meÄ±ny	'mountain'
meÄ±rÄ±e	valley
meÄ±sao	overwhelming
moafa	teleports
moanuoÄ±	bites
moaqchÄ±e	memorizes
moaqge	is a reminder
moaqhua	memory
moaqshuetao	memorizes
moaqtao	recalls
moashuao	moa
moasuaÄ±	occurs suddenly
moaÄ±kaÄ±	writes
moaÄ±laÄ±	letter
mochela	morel
moecey	gasps
moechoa	moans
moechou	heartfelt
moecyhy	gasps
moecÄ±a	emotionless
moefea	tolerates
moefoa	fickle
moegaq	empathizes with
moegaq	sympathizes with
moekuaÄ±	feels deadpan
moekÄ±aq	eyebrow
moelaÄ±	emoji
moenotuq	loses their cool
moenuoq	feels sympathy
moepÄ±a	soul-sibling
moeroe	OK
moese	emotion
moeshea	emotionally numb
moetao	vibes experience
moetoa	interjection
moetuaÄ±	spirit, soul
moku	dark
mokuq	quotes text
molaÄ±	open-quote
mole	one mole
moma	ear
momoq	Mormon
monachu	monk
monha	forgets to do
moqkoy	questions
moqkuaq	asks
moqlaÄ±	question mark
moqsuta	monster
mora	mora
moraÄ±	text
moruÄ±	ant
moruÄ±meÄ±	formicary
morÄ±	ant
morÄ±bue	ant nest
moteo	text
moteolaÄ±	quotes
mouko	mucus
moy	dark
moykuo	pitch black
moÄ±baq	mind
moÄ±bÄ±a	mentally ill
moÄ±bÄ±adÄ±u	psychiatry
moÄ±bÄ±adÄ±uche	psychiatrist
moÄ±deoq	telepathic
moÄ±deoqkuq	says
moÄ±faÄ±	neurotypical
moÄ±guaÄ±	does mental work
moÄ±guaÄ±rÄ±aq	office
moÄ±haq	food for thought
moÄ±huanoÄ±	headache
moÄ±huanoÄ±lÄ±e	has a headache
moÄ±huatoaÄ±	braincell
moÄ±jua	puzzling
moÄ±koaÄ±	neural network
moÄ±kuq	thinks of saying
moÄ±leÄ±	neurodivergent
moÄ±luaq	plays puzzle
moÄ±luaqmu	puzzle game
moÄ±luq	thoughtful
moÄ±poaqse	"compartment"
moÄ±puao	thought bubble
moÄ±rÄ±eq	escapes from
mu	and
mu	and
muaogaÄ±	parses
muaogaÄ±se	parse tree
muaoguaqkune	bush dog
muaoguaqtaqraka	streaked tenrec
muaogÄ±etuaq	antler
muaohoaqpÄ±o	charcoal
muaoluo	grove of trees
muaomuoq	wooden
muaomÄ±a	forest
muaopÄ±u	bark of a tree
muaosaÄ±muoq	wooden
muaotuaq	antler
muaq'aÄ±	lifeless
muaqbue	grave
muaqbueme	graveyard
muaqcuaojÄ±aq	afterlife world
muaqdueq	graveyard
muaqdÄ±eqme	Internet
muaqhaqtu	ghost
muaqhoe	stellar remnant
muaqjaÄ±	happy
muaqjoaÄ±	hunts
muaqkao	obituary
muaqkuaÄ±	feels suicidal
muaqlua	obituary
muaqmeo	mourns
muaqpÄ±o	tombstone
muaqrÄ±o	carbon monoxide
muaqshao	suicidal
muaqshoguobe	African buffalo
muaqshose	death
muaqtaÄ±	slays
muaqtea	in agony
muaqtoaÄ±	infectious
muaqtuaÄ±	corpse
muaqtue	death
muaqtÄ±aÄ±	coffin
muaraq	specific
muchoa	moos
mueqkea	computer
muguqrua	hibiscus flower
muka	musk deer
muobugoaÄ±cha	affricate
muochoq	uses up
muochoqte	used up
muogoÄ±	cures
muomÄ±e	living being
muoqfÄ±u	sparse
muoqjaq	massive
muoqmea	element
muoqpuÄ±	heterogenous
muoqshoa	dense
muoqshÄ±	homogenous
muoqtoaÄ±	atom
muoqtuao	has a small mass
muoseu	integer
muosoÄ±	is at war with
muozÄ±u	integer
muozÄ±u	integer
muoÄ±	rotates
muoÄ±	rotates
muoÄ±cÄ±oq	crank
muoÄ±duy	rolls
muoÄ±hua	neck
muoÄ±hupa	screws
muoÄ±hupachuo	a screwdriver
muoÄ±me	mixture
muoÄ±moe	dizzy
muoÄ±poechuo	screw
muoÄ±rÄ±aÄ±	axle
muoÄ±shoaÄ±	a
muoÄ±shoaÄ±chao	helicopter
muoÄ±shua	falls laterally
muoÄ±toÄ±	tortures
mupao	forest
muqbaÄ±	makes by hand
muqbaÄ±se	handmade
muqbea	wrist
muqbeagÄ±a	wristband
muqceaq	fingernail
muqcheÄ±bea	knuckle
muqdapa	hand palm
muqdoa	hands
muqduo	waves at
muqgoeq	railing
muqhÄ±o	waves hello
muqkaÄ±	handwrites
muqkaÄ±se	handwriting
muqkea	cell phone
muqkoê¡am	pocket watch
muqne	handful
muqnotuqkea	grenade
muqnua	grabs
muqpata	french fry
muqse	handprint
muqseaq	fists
muqshoaÄ±	bat
muqtoq	palm of a hand
muqtÄ±oq	handcuff
muqzu	sign language
mura	and
muraq	dark
muse	mouse
musekea	computer mouse
musekusu	cucumber
musela	weasel
muselamelÄ±	ferret-badger
musenuÄ±	house mouse
musoky	Korean shamanist
musylÄ±q	Islamic
mute	garbage
muteheq	trash can
muteheqchuo	trash can
muteheqmy	trash can
muty	blocked
muy	us
muÄ±bo	meaningful
muÄ±bomÄ±u	perceives
muÄ±bÄ±ao	perplexed
muÄ±chuo	argument
muÄ±cÄ±a	asemic
muÄ±dao	definition
muÄ±deoq	explains
muÄ±doa	assigns meaning
muÄ±heq	hypernym
muÄ±huÄ±	pejorative
muÄ±huÄ±sheo	feels guilty
muÄ±juoÄ±	defines
muÄ±juq	understands
muÄ±koe	disambiguates
muÄ±lÄ±aq	synonyms
muÄ±lÄ±aqgÄ±q	antonyms
muÄ±lÄ±aqkue	thesaurus
muÄ±mu	has meaning
muÄ±mÄ±a	rich in meaning
muÄ±mÄ±u	perceives
muÄ±mÄ±u	thinks that
muÄ±nÄ±e	hyponym
muÄ±nÄ±elÄ±aq	co-hyponyms
muÄ±nÄ±emu	hypernym
muÄ±paq	is a nuance
muÄ±paqbo	contains nuance
muÄ±puq	polysemous
muÄ±shÄ±	monosemous
muÄ±toa	predicate word
muÄ±toa	content word
muÄ±toaÄ±	sememe
myÄ±	us
mÄ±ajÄ±eq	manic
mÄ±ala	silver
mÄ±ao	moon
mÄ±aoboe	mooncake
mÄ±aobÄ±a	has PMS
mÄ±aochoa	meows
mÄ±aodoaÄ±	mooncake
mÄ±aodoaÄ±	mooncake
mÄ±aogÄ±o	moonlight
mÄ±aoloha	silver
mÄ±aoluko	werewolf
mÄ±aonÄ±aq	lunar year
mÄ±aopÄ±o	moonstone
mÄ±aozaq	moonrise
mÄ±aqbo	has value
mÄ±aqcÄ±a	worthless
mÄ±aqmÄ±a	valuable
mÄ±aqmÄ±eq	evaluates
mÄ±aqmÄ±q	invaluable
mÄ±aqsao	valuable
mÄ±aqtoÄ±	celebrates
mÄ±at	moneran
mÄ±aÄ±fÄ±a	onset
mÄ±aÄ±laqteÄ±	syllabic tone
mÄ±aÄ±me	rhyme scheme
mÄ±aÄ±ruo	and
mÄ±aÄ±rÄ±oq	rime
mÄ±aÄ±toaÄ±	syllable
mÄ±aÄ±tÄ±aÄ±	cube
mÄ±dÄ±e	rosemary
mÄ±e'aÄ±	lively
mÄ±ebÄ±e	afterlife
mÄ±ecÄ±u	births
mÄ±edaosaÄ±	nucleic acid
mÄ±edua	savoir-vivre
mÄ±edÄ±u	biology
mÄ±egoeq	membrane
mÄ±eguo	life
mÄ±egÄ±	well
mÄ±ehe	lifeform
mÄ±ehuaq	outlives
mÄ±ekaze	heartbeat
mÄ±elua	bio
mÄ±elÄ±e	goes about
mÄ±eme	biome
mÄ±enetoaÄ±	hit point
mÄ±epÄ±o	fossil
mÄ±eqsÄ±	analyzes
mÄ±eqtao	does
mÄ±eqtaÄ±	determines that
mÄ±eqtoÄ±	conducts on
mÄ±erÄ±o	dioxygen
mÄ±erÄ±o	dioxygen
mÄ±erÄ±oq	species
mÄ±erÄ±oqdÄ±u	taxonomy
mÄ±erÄ±oqjeq	fellow creature
mÄ±erÄ±oqjeqchuq	cannibal
mÄ±eshÄ±	living being
mÄ±esÄ±aÄ±	lifeblood
mÄ±etao	lives
mÄ±etoaÄ±	biological cell
mÄ±etoaÄ±loy	fermented
mÄ±etuaÄ±	living body
mÄ±etue	life
mÄ±etÄ±aÄ±	chest
mÄ±ezueq	injured
mÄ±ezuy	injured
mÄ±eÄ±	has
mÄ±kaqbÄ±a	has migraines
mÄ±mÄ±	meme
mÄ±mÄ±	mime
mÄ±mÄ±y	us
mÄ±ocuÄ±	of the color
mÄ±ofubuche	blue duiker
mÄ±oguobe	nilgai
mÄ±ohobÄ±	bharal
mÄ±oketo	rorqual
mÄ±oketosÄ±u	balaenopterid
mÄ±oloa	colour blurple
mÄ±onÄ±oq	bluetooth
mÄ±oroq	elephant seal
mÄ±ozeo	blueberry
mÄ±qdale	almond
mÄ±qgÄ±q	is finite
mÄ±qgÄ±qdoa	lends
mÄ±qjao	infinitely far
mÄ±qkaqbÄ±u	kaleidoscope
mÄ±qly	pearl
mÄ±qnao	seawater
mÄ±qtekÄ±oq	breath mint
mÄ±rupÄ±o	opal
mÄ±sotuzy	miso soup
mÄ±uchey	engineers in
mÄ±ucÄ±a	is indifferent
mÄ±udeaÄ±	tenable
mÄ±udoetua	manipulates
mÄ±uheo	and
mÄ±uheoraq	and
mÄ±ujeqraq	and
mÄ±ule	plausible
mÄ±umÄ±eq	polls
mÄ±uq	feigns
mÄ±use	opinion
mÄ±ushue	maintains that
má»¥rom	in danger
naby	bread
nabybeaq	breadstick
nabycake	pastry
nabydashÄ±	dough
nabypoachuo	bread clip
nabyru	sandwich
nabyzeo	breadfruit
nabÄ±	spiritual
nabÄ±poq	shaman
nacho	nacho
nadeq	adder
naho	garlic
namakocÄ±a	simple
namakolaÄ±	dingbat
namdashÄ±	dough
namru	sandwich
namru	sandwich
namrukuha	grilled cheese
namrÄ±aq	bakery
namÄ±	south
namÄ±hochu	south-east
namÄ±hore	south-west
namÄ±kenobo	Pampas deer
namÄ±merÄ±ka	South America
namÄ±moa	south pole
namÄ±poq	southerner
namÄ±soq	south pole
nano	Nano
nao'aÄ±	liquid
naobebere	otter civet
naobeq	wave
naoboenÄ±u	water lily
naocheoq	water bottle
naochÄ±a	dehydrated
naocoa	aqueduct
naogoaq	slippery
naogoeq	dam
naoguobe	sea slug
naoguobe	Asian buffalo
naogÄ±okea	lava lamp
naohaq	soup
naohepete	marsh mongoose
naojeoq	well
naojeoq	well
naojÄ±u	hydrogen
naokaronuÄ±	water chevrotain
naokaÄ±chuo	pen
naokenobo	water deer
naokeq	diarrhea
naokusu	melon
naoloha	mercury
naoloqchuo	kettle
naoloy	boiled
naolÄ±aÄ±	swims
naomusela	Eurasian otter
naomy	(a) liquid
naomÄ±q	sea
naomÄ±qmusela	sea otter
naomÄ±qrea	coast
naoneo	floats
naonÄ±e	is underwater
naonÄ±u	alga
naopada	leopard seal
naopeo	soaks into
naopoÄ±ba	seagrass
naorÄ±o	steam
naosaÄ±	liquid
naosho	melts
naoshoaÄ±	fin
naoshuo	water reservoir
naosoresÄ±u	otter shrew
naosueq	water wave
naosuhu	capybara
naosuy	water wave
naosÄ±ao	water spring
naosÄ±qtua	washes
naosÄ±u	liquid
naozue	puddle
naq'aÄ±	masculine
naq'aÄ±	masculine
naqbaka	bull
naqcÄ±o	adolescent boy
naqfu	son
naqga	soap
naqgo	lad
naqgoso	rooster
naqguoso	bull
naqhupÄ±	dogfox
naqkata	king
naqlaÄ±	male sign â™‚
naqmaÄ±	attracted to men
naqpaoguqkÄ±aq	candy floss
naqpoaÄ±	spermatozoid
naqruo	masculine
naqsaÄ±	androgen
naqseaqnao	cum
narabÄ±	tray
narabÄ±boe	baking sheet
naraqkÄ±a	vermilion
naraqlue	amber
naraqnaokusu	cantaloupe
naraqzeo	orange
naraqzeonao	orange juice
nasa	mad
naso	nose
nasokaro	saiga
naÄ±bÄ±	is in state
naÄ±bÄ±jÄ±oq	state machine
naÄ±bÄ±se	state
naÄ±daq	now
naÄ±jÄ±a	about to happen
naÄ±na	cool
naÄ±shÄ±	widow(er)
naÄ±teqkata	debit card
naÄ±toa	nonce word
neagÄ±aq	pop music
neao	ashamed
neaochÄ±aq	embarrassed
neaochÄ±aqca	embarrasses
neaqpÄ±o	sandstone
neaqseoqtue	sandstorm
neaqtoaÄ±	grain of sand
neatuÄ±fua	bench
necÄ±oq	knob
nedao	numerical data
neheo	differs
nejeq	and
neka	filters through
nemesÄ±	nemesis
nenea	spectrum
neocoeq	stack
neohaq	cake
neopaq	layer
neopaqnuofua	bunk bed
neoq'Ä±um	neon
neoqsoq	His
neoqtoÄ±	is obsequious
neotoq	shelf
nepe	ratio
neqcÄ±toq	die
neqfaq	happens randomly
neqgam	die
neqgeq	comes across
neqjoÄ±	coincidental
neqkuÄ±	random
neqluaq	gambling game
neqmy	lucky charm
neqraÄ±	lucky charm
neqteq	gambles
nese	impact
neu	=
neu	sum
neuluo	is a family with
neume	sum of all
ney	ashamed
neÄ±jue	September
neÄ±kata	nine
nhabuaq	falls behind
nham	dear
nhamo	remembers to do
nhaojÄ±	us
nhaqchoa	meows
nhaqdeo	catboy
nhaqnhaqly	kitty cat
nhaqpoq	catboy
nhashaÄ±	drops intention
nheakato	serval
nheheo	and
nhejaÄ±	furry
nheoÄ±nuo	sleeps
nhochoa	mhms in approval
nhoe	occurs in medium
nhoka	cute lil paw
nholÄ±	is the range
nhom	affectionate
nhoq	cord
nhoqcÄ±oq	tripwire
nhoqgu	ingests
nhou	affectionate
nhougoaÄ±	pets, strokes
nhoupaÄ±	romantic
nhoutue	romance
nhoy	imaginary
nhoyzÄ±u	imaginary number
nhuo	array, battery
nhuoby	blankie
nhuocÄ±oq	tab
nhuogÄ±	ordered
nhuohuÄ±	disorderly
nhuokueq	line up
nhuopeo	combs through
nhuopeomy	comb
nhuopÄ±o	crystal
nhuoreaq	row
nhuosheaq	column
nhuotÄ±	arranged
noaca	is a problem
noaleÄ±	is averse
noaqba	cites
noaqchoa	recites text
noaqfua	lectern
noaqgÄ±okea	reading lamp
noaqjÄ±oqjuao	screen reader
noaqkuq	recites
noaqnuoqmoÄ±	subvocalizes
noaÄ±bao	cream-colored
noaÄ±chaÄ±	milk tea!!!
noaÄ±chuaÄ±	ice cream
noaÄ±duaosaÄ±	lactose
noaÄ±dÄ±ou	lactose
noaÄ±gaq	cereal
noaÄ±gulaq	mammary gland
noaÄ±kafe	caffe latte
noaÄ±nua	milks
noaÄ±nulÄ±	butter
noaÄ±shuaq	produces milk
noaÄ±shuaqhua	mammary gland
nobatao	is disposed to
nodoa	uses medium
noeqtuoÄ±	is a loophole in
nofÄ±eq	adapts
nogenuÄ±naomusela	clawless otter
nohenoshuaq	transcribes
noheo	translation
noqbo	has the taste
noqcaÄ±	flavorful
noqchoÄ±	spicy
noqcÄ±a	bland
noqde	tastes beautiful
noqdoa	flavors
noqdoase	flavor
noqhÄ±aq	poor in taste
noqloq	spicy
noqmÄ±a	rich in taste
noqnÄ±u	herb
noqpua	tasty
noqpuo	spice
noqrue	weak
noqrue	tastes mild
noqsaÄ±	spice
noqse	taste
noqsÄ±u	tastes like
nose	format
noteÄ±	format
notua	adapts
notuq	explodes
notuqjeoq	crater
notuqkea	bomb
notuqpuo	gunpowder
notuqsaÄ±	explosive
noy	liquid
noÄ±	feels pain in
noÄ±budo	Ä±s a snake
noÄ±cha	painful
noÄ±toÄ±	tortures
nu'aÄ±	reminds one of
nua	takes
nuache	thief
nuadoa	lends property
nuagoaÄ±	wears
nuam	arch
nuaobeaq	spring, coil
nuaobo	crooked, bent
nuaobÄ±o	cup
nuaocÄ±a	straight, flat
nuaocÄ±amÄ±q	geometric plane
nuaoduy	bows
nuaofurÄ±	rocks
nuaokuoq	rib
nuaomÄ±a	twisty
nuaoruoq	wavy
nuaq'aÄ±gÄ±aq	nightcore
nuaqhoe	star
nuaqmuo	occurs all night
nuaqtÄ±qshoaÄ±	moth
nuaÄ±bo	has money
nuaÄ±boe	bill
nuaÄ±chuaq	capitalism
nuaÄ±cokÄ±	financial system
nuaÄ±dÄ±e	bribes
nuaÄ±feoq	coins
nuaÄ±gou	paid
nuaÄ±goucÄ±a	unpaid
nuaÄ±hea	coin
nuaÄ±heq	wallet
nuaÄ±loha	gold
nuaÄ±lÄ±aÄ±	in debt
nuaÄ±maÄ±	miser
nuaÄ±nhe	incurs a cost
nuaÄ±peq	money note
nuaÄ±rÄ±oq	currency
nuaÄ±shuo	bank account
nuaÄ±tuaÄ±	physical money
nubeÄ±	indeed so
nubo	is such as
nuebuaq	fails
nuekao	contract
nuekao	contract
nuepo	bussy
nueq	is meat
nueqbÄ±u	sausage
nueqche	butcher
nueqchuq	carnivorous
nueqcÄ±achuq	vegetarian
nueqhaq	meat
nueqkÄ±apÄ±o	carnelian
nueqmuo	pancreas
nueqrÄ±edoaÄ±	burger
nueqrÄ±eq	vegetarian
nueqshoaÄ±	Sarcopterygii
nueqtuo	carnivoran
nueshaÄ±	flakes on
nuetaq	intends to do
nuja	makes with
nuja	makes with
nujaq	case to this
nukuq	says like this:
nulÄ±	grease
nulÄ±baÄ±	fries
nulÄ±doa	oils
nulÄ±hÄ±eq	spatters oil
nulÄ±loy	fried
nulÄ±muoq	dairy
nulÄ±nuty	tenkasu
nulÄ±nuÄ±	skinny
nulÄ±pÄ±o	asphalt
nulÄ±sao	fat
nulÄ±saÄ±	butter
nulÄ±se	is fried
nunuq	worm
nuoboe	blanket
nuobÄ±ao	drowsy
nuocaÄ±	fast asleep
nuochoa	snores
nuocholÄ±	mattress
nuocÄ±use	rheum
nuofa	goes to bed
nuofualÄ±a	bedside
nuogaÄ±	dreams
nuogaÄ±se	dream
nuogaÄ±sekoaÄ±	dreamcatcher
nuoge	dream
nuohÄ±aq	sleep-deprived
nuojÄ±aq	dream world
nuokoÄ±	somnambulates
nuokuaÄ±	sleepy
nuoneaq	rheum
nuoqchoa	repeats
nuoqfua	mirror
nuoqfua	mirror
nuoqfuaq	reflection
nuoqjeqtaq	symmetric
nuoqmy	mirror
nuoqmÄ±a	brilliant
nuoqrea	shiny
nuoqse	reflection
nuoqshÄ±a	mirror
nuoqsuoÄ±	brilliant
nuorÄ±aÄ±	mattress
nuosofa	pullout couch
nuosoÄ±	has a nightmare
nuosuaq	sings lullaby
nuotoa	dreamt-up word
nuotuao	half-awake
nuoÄ±guonÄ±aÄ±	ruminant
nuoÄ±hua	jaw
nuoÄ±huabeq	chin
nuoÄ±huakÄ±aq	beard
nuoÄ±zeo	berry
nupÄ±	pebble
nuq'o	"does back"
nuqleq	anteater
nuqmusela	marbled polecat
nuru	worm-like animal
nutuao	case this
nuty	dregs
nuy	"does back"
nuÄ±beaq	wand
nuÄ±chuq	eats a snack
nuÄ±dao	detail
nuÄ±foq	mobile phone
nuÄ±haq	snack
nuÄ±hoe	photon
nuÄ±huÄ±	pathogen
nuÄ±jaq	tiny
nuÄ±kaqchuo	microscope
nuÄ±kaÄ±	writes
nuÄ±kÄ±oq	marble
nuÄ±laÄ±	lowercase letter
nuÄ±m	star
nuÄ±meÄ±	hill
nuÄ±mlaÄ±	asterisk
nuÄ±mpuo	stardust
nuÄ±muÄ±	definition
nuÄ±mÄ±e	microbe
nuÄ±mÄ±ejuq	ferments
nuÄ±mÄ±ejuqluÄ±	fermented
nuÄ±nao	pond
nuÄ±neohaq	cupcake
nuÄ±paq	detail
nuÄ±poaq	breaks
nuÄ±poq	short person
nuÄ±pÄ±anete	dwarf planet
nuÄ±seje	LGBT+
nÄ±abuq	frowns
nÄ±amÄ±q	abyss
nÄ±ao(neo)koÄ±	skiis
nÄ±aoboe	snowflake
nÄ±aopoq	snow figure
nÄ±aotoaÄ±	snowflake
nÄ±apuao	mist
nÄ±aqgeone	age, in years,
nÄ±aqgu	two-year period
nÄ±aqheÄ±	decade
nÄ±aqjue	is calendar
nÄ±aqjuehoe	solar calendar.
nÄ±aqjuemÄ±ao	lunar calendar
nÄ±aqme	age
nÄ±aqmoa	time of the year
nÄ±aqnÄ±qchaq	New Year's Day
nÄ±aqnÄ±qlaochaq	New Year's Eve
nÄ±aqshochaq	is
nÄ±ashÄ±aq	lower leg
nÄ±aÄ±'aÄ±	feral
nÄ±aÄ±bepoaÄ±	egg
nÄ±aÄ±bue	animal shelter
nÄ±aÄ±cho	furry
nÄ±aÄ±chuoÄ±	leash
nÄ±aÄ±dÄ±u	zoology
nÄ±aÄ±goÄ±che	veterinarian
nÄ±aÄ±guaq	animal farm
nÄ±aÄ±kÄ±aq	fur
nÄ±aÄ±kÄ±aÄ±	has pet
nÄ±aÄ±nhoq	leash
nÄ±aÄ±pao	raises
nÄ±aÄ±poaÄ±	egg
nÄ±aÄ±poaÄ±	egg
nÄ±aÄ±poq	therian
nÄ±aÄ±se	animal product
nÄ±aÄ±serÄ±eq	vegan
nÄ±aÄ±serÄ±eqchuaq	veganism
nÄ±aÄ±soaq	zoo
nÄ±bo	this
nÄ±ce	69s with
nÄ±ce	local node
nÄ±daq'aÄ±	modern
nÄ±daqgoa	here and now
nÄ±daqme	this time period
nÄ±daqtÄ±ao	modern
nÄ±daqtÄ±aobu	antiquated
nÄ±dÄ±osÄ±ao	this morning
nÄ±e	is inside
nÄ±ecaha	breathes in
nÄ±ece	entrance
nÄ±efuq	underwear
nÄ±egaÄ±kea	endoscope
nÄ±egoa	space inside
nÄ±ejÄ±aÄ±	virus
nÄ±elÄ±a	inner side
nÄ±em	raw
nÄ±emuo	is wholly within
nÄ±enua	empties
nÄ±eqfoq	feature phone
nÄ±eqluaÄ±	silly
nÄ±erÄ±aq	entrance
nÄ±etaose	indeed the case
nÄ±etÄ±no	intestine
nÄ±ezobo	underpants
nÄ±goa	here, this place
nÄ±gu	knits
nÄ±hoq'Ä±um	Nihonium
nÄ±hu	additive inverse
nÄ±jaofa	goes
nÄ±jaq	case to this
nÄ±juÄ±	nearby
nÄ±juÄ±fa	comes
nÄ±jÄ±aq	real world
nÄ±ka	indicates
nÄ±kela	nickel
nÄ±kyloha	nickel
nÄ±mÄ±ao	is
nÄ±nÄ±aqme	current era
nÄ±nÄ±buÄ±	extraterrestrial
nÄ±oka	mammalâ€™s paw
nÄ±okato	kitten
nÄ±oqchuo	saw
nÄ±oqgoaÄ±my	toothbrush
nÄ±oqgoÄ±che	dentist
nÄ±oqguka	gnaws
nÄ±oqgukanÄ±aÄ±	rodent
nÄ±oqjÄ±aÄ±	bites onto
nÄ±oqketea	toothed whale
nÄ±oqketo	toothed whale
nÄ±oqkoÄ±	walrus
nÄ±oqkoÄ±sÄ±u	odobenid
nÄ±oqnueq	gums
nÄ±oqsaÄ±	ivory
nÄ±oqsutÄ±abeqtÄ±	denti-alveolar
nÄ±oqsÄ±oq	cogwheel
nÄ±oqsÄ±oqme	gears
nÄ±oqsÄ±qsaÄ±	toothpaste
nÄ±oqtoechuo	saw
nÄ±oqtÄ±	dental
nÄ±oqtÄ±abeq	alveolar ridge
nÄ±oqtÄ±abeqtÄ±	alveolar
nÄ±oqtÄ±asutÄ±	post-alveolar
nÄ±oshuaÄ±	innocent
nÄ±q	new
nÄ±qbÄ±ao	surprised
nÄ±qchoaq	newcomer
nÄ±qchuq	chews cud
nÄ±qchÄ±e	is a beginner
nÄ±qguomute	recyclable trash
nÄ±qguomuteheq	recycling bin
nÄ±qguomÄ±e	revived
nÄ±qgÄ±	has novelty
nÄ±qgÄ±ucÄ±oq	new line
nÄ±qja	ninja
nÄ±qjacua	ninjas
nÄ±qjatao	ninjas
nÄ±qjey	has xenogender
nÄ±qjÄ±u	reborn
nÄ±qkaÄ±	writes
nÄ±qkue	news bulletin
nÄ±qkÄ±utua	recycles
nÄ±qluÄ±	familiar
nÄ±qmuo	up-to-date
nÄ±qnÄ±aqchaq	New Year's Day
nÄ±qnÄ±aqlaochaq	New Year's Eve
nÄ±qpaq	addition
nÄ±qpÄ±q	nitpicks
nÄ±qreq	newborn child
nÄ±qrÄ±o	fresh air
nÄ±qsaÄ±	is
nÄ±qteÄ±saÄ±	neoplasma
nÄ±qtoaq	neo-Toaqic
nÄ±qtua	updates
nÄ±qzÄ±akea	repeater
nÄ±rÄ±aq	here, this place
nÄ±tojeq	nitrogen
nÄ±tosaÄ±	is
nÄ±tuao	case this
nÄ±tÄ±	here
nÄ±ubepoaÄ±	seed
nÄ±uchuaqchuq	(a) vegan
nÄ±udÄ±u	botany
nÄ±udÄ±uche	botanist
nÄ±uguaq	farm
nÄ±uhaq	phosphorus
nÄ±uheqmy	planter
nÄ±ukueq	salad
nÄ±uly	bunny
nÄ±unaqpoaÄ±	pollen
nÄ±upoaÄ±	seed
nÄ±upoaÄ±	seed
nÄ±upuao	organic smoke
nÄ±upuo	starch
nÄ±urÄ±qsaÄ±	chlorophyll
nÄ±usaÄ±	organic matter
nÄ±usoaq	botanical garden
nÄ±usÄ±aÄ±	sap
nÄ±usÄ±aÄ±pÄ±o	amber
nÄ±y	that over there
nÄ±Ì‡qpÄ±q	nitpicks
oaomo	letter '
obane	mass
obelaÄ±	exclamation mark
ocara	Ostara
ocha	human
ocha	sentient being
ocha'aÄ±	anthro
ochasesaÄ±	plastic
ocÄ±	ice mummy
ocÄ±jeq	oxygen
oganesoq	Oganesson
oguÄ±	snake
oguÄ±pÄ±u	snake skin
okeÄ±	OK
okeÄ±jÄ±e	accepts
ole	Orwellian
olea	olive tree
oma	lump
opeolaÄ±	letter Ã˜
oqsÄ±saÄ±	is
oreo	inhuman
oreq	human
orogÄ±	orchid
osaraÄ±sÄ±u	true oyster
ota	oats
otakocy	oatmeal
otanÄ±u	oats
ou'ouko	letter Ou
ouko	conifer cone
oukomuao	conifer
oukonÄ±u	conifer
ourebÄ±	oribi
oy'o	owos
oÄ±'oÄ±ne	letter OÄ±
oÄ±lazÄ±u	Euler's number e
oÄ±lyzÄ±u	Euler's number
oÄ±ne	screw
oÄ±nesheq	screwdriver
paba	avocado tree
pabahaq	guacamole
pabanao	guacamole
pabazeo	avocado fruit
pagaq	pagan
pagechÄ±moqsutachuaq	Pastafarianism
pagechÄ±moqsutachÄ±	Pastafarian
paku	wax
pakutÄ±e	waxed
pakÄ±rasÄ±u	peccary
pala	(hard) palate
pala	(hard) palate
palaq	hand palm
palate	palatized
palatÄ±	palatal
palatÄ±na	platinum
pana	god Pan
panama	Panamanian
panamagua	Panama
paopao	grandparent
paparua	poppy
papy	papilla
paqbo	has part
paqboq	interferes with
paqboshaÄ±	loses part
paqbosho	gains part
paqchoq	uses up some
paqchuo	piece
paqchÄ±o	take turns doing
paqchÄ±ose	turn
paqdoa	contributes
paqdÄ±u	mereology
paqgo	has part
paqkaÄ±	spells out
paqkygÄ±aq	punk rock
paqmetuq	power set
paqmu	has part
paqmuo	entirety
paqmÄ±a	complex
paqmÄ±eq	analyzes
paqne	some portion
paqsho	meshes into
paqsho	gains part
paqtoe	notches
paqtÄ±	panties
paruha	pharaoh
paruhay	pharaoh
paruq	pharynx
parÄ±q	pharynx
parÄ±qtÄ±	pharyngeal
pasho	splashes liquid
pashosuê¡e	splash
pasyka	Easter
pata	pasta
patÄ±chea	party hat
pazÄ±	annoyed
paÄ±chua	nickname
paÄ±chÄ±tuq	baiji
paÄ±chÄ±tuqsÄ±u	baiji
paÄ±de	cute
paÄ±fuo	pats
paÄ±gaq	companion
paÄ±goaÄ±	strokes
paÄ±gÄ±q	enemy
paÄ±gÄ±qruo	acts mean
paÄ±huÄ±	is cruel
paÄ±jÄ±	friend of mine
paÄ±kuaÄ±	squishes
paÄ±luo	found family
paÄ±me	friend group
paÄ±nÄ±aÄ±	pet
peha	figuratively
pekaq	fisher
pele	spot
pelekato	marbled cat
peleshÄ±qhua	addax
peloq	rank
pelua	pelvis
peodoa	injects
peokÄ±u	hole
peonua	extracts
peopaqhako	short-faced bear
peoq	chemical element
peotoe	(agentive) stabs
peotoqhua	diaphragm
peqboe	sheet of paper
peqgÄ±q	penguin
peqheq	folder
peqjuo	letter
peqjuo	paper letter
peqno	written down
peqnuaÄ±	paper money
peqtoq	clipboard
pesahy	Pesach
peso	penis
peso'aÄ±	phallic
pesofuq	condom
pesojoq	penis head
pesopÄ±u	foreskin
pesoreq	Homo Phallicus
pesotÄ±e	condom
pesÄ±tÄ±	plague
petero	true sparrow
peteroteÄ±	passerine
peteÄ±	relative
peteÄ±	louse
petÄ±	plague
peÄ±	tensor
peÄ±chua	monomial
peÄ±cuaq	number
peÄ±ka	European magpie
peÄ±kasÄ±u	magpie
peÄ±ke	European magpie
po'aqhuÄ±tuaruaq	blames, accuses
poabuÄ±	trapped
poachoatoaÄ±	consonant
poanÄ±e	trapped
poaqchuq	chews
poaqfuÄ±	fragile
poaqgÄ±u	fissure
poaqhea	chip(ping)
poaqkuaÄ±	brittle
poaqmarÄ±kÄ±	popcorn
poaqnoa	resilient
poaqreÄ±	crushes
poaqshua	collapses
poaqzÄ±u	rational number
poasho	closes
poatoame	clause
poatÄ±e	lid
poaÄ±kÄ±oq	egg
poaÄ±nao	seed
poaÄ±nÄ±aÄ±	wildebeest
poaÄ±pao	baobab
poaÄ±puao	meringue
poaÄ±puo	pollen
poaÄ±rÄ±aq	ovary
poaÄ±shuo	testicle
poaÄ±sÄ±aÄ±cÄ±u	menstruates
poaÄ±toaÄ±	ovum (egg cell
pocÄ±a	lacks
podÄ±	fern
poechea	umbrella
poeduaÄ±tue	segregation
poedÄ±zu	is a stylized
poegÄ±a	fence
poegÄ±qjeo	inalienably
poekÄ±ubu	inalienable
poemoe	feels outcast
poepaq	piece
poerue	elusive
poeseo	metamour
poetoq	wall
poetoqboe	poster
poetoqtoaÄ±	brick
poga	is
poha	one's
poha	refers to
pohÄ±	whose?
pojÄ±ao	holy
poka	hip
pokemoq	pokemon
pokesao	harbour porpoise
pokesao	typical porpoise
pokesaosÄ±u	porpoise
pokesÄ±u	true seal
polaq'Ä±um	Polonium
pom	egg
pomuy	ours
ponÄ±	of this
popÄ±	poppy
poqbo	master
poqchua	given name
poqfuaq	portrait
poqgaq	fellow person
poqhegÄ±	eudaimonia
poqhoÄ±toa	personal pronoun
poqhuÄ±moÄ±	social anxiety
poqjoe	socially apt
poqjuao	societal law
poqkata	personal ID card
poqkea	robot
poqkoja	abducts
poqmecuetaq	democracy
poqnÄ±eq	socially awkward
poqpegÄ±	popular
poqpoe	dehumanizes
poqpuqreq	plural system
poqrÄ±oq	personality type
poqse	identity
poqshea	desert
poqshÄ±req	singlet
posa	is associated
potashÄ±um	potassium
potato	potato
potoateÄ±	genitive case
potuaÄ±	physical form
pou	owns
pouse	possession
pozola	podzol
poÄ±ba	grass
poÄ±bakaro	reedbuck
poÄ±basÄ±u	true grass
poÄ±be	grass
poÄ±la	plucks
pu'aobÄ±	period piece
puadao	pleasure
puagoaÄ±	strokes
puagÄ±	fun
puakoÄ±	strolls
puao'aÄ±	fluffy
puaobeaq	cigar
puaocuao	skyscraper
puaocÄ±a	free of clouds
puaofuq	sweater
puaokato	clouded leopard
puaokÄ±aq	wool
puaokÄ±aq	afro
puaokÄ±oq	dandelion clock
puaonÄ±u	dandelion clock
puaopÄ±e	smokes
puaorua	dandelion
puaqcÄ±a	numb
puaqgÄ±goaÄ±ca	massages
puaqhua	tactile organ
puaqkÄ±aq	whisker
puaqkÄ±ky	yucky
puaqnoaq	reads Braille
puaÄ±bebue	orphanage
puaÄ±beodÄ±u	chaos theory
puaÄ±loe	wild fire
puaÄ±luko	wolf
puaÄ±luko	wolf
puaÄ±rÄ±e	rural
puche	historian
pucÄ±q	poutine
pudÄ±o	today
pudÄ±u	history
puebea	ankle
puebeq	foot heel
puebeqgea	high heels
puebÄ±o	goblet
puebÄ±u	socks
puecea	sock
pueceaq	toenail
puecheÄ±	toe
puecÄ±oq	pedal
puedapa	foot sole
puefuqchuoÄ±	shoelace
puefuqcÄ±a	barefoot
puefuqdapa	shoe sole
pueguy	sock
puehÄ±eqte	podcast
puejÄ±aÄ±chuo	foothold trap
puekÄ±oq	soccer
pueqbuaq	trips
pueqmy	staircase
pueqmytoaÄ±	stair
pueruedea	taps their foot
puerÄ±aÄ±	foot stool
puese	footprint
pueshÄ±aqgao	tights
puetuq	sole (of a) foot
puetÄ±e	sock
puga	leather
pugÄ±aqdÄ±u	history of music
pujoa	last week
pujue	last month
pujÄ±a	was
pukao	record
puku	brittle
pukuaÄ±	nostalgic
puma	puma
pumeche	historian
pumoe	feels nostalgia
pumoq	lung
pumoqdÄ±qnhuo	bellows
punuaq	last night
punÄ±aq	last year
puochÄ±q	dust mite
puokaqbÄ±a	has visual snow
puole	friable
puonueq	ground meat
puoq	happens to do
puoqgÄ±	is good
puoqhuÄ±	is bad
puoqtÄ±ao	fits
puosho	crumbles apart
puoshuao	phoenix
puotoaÄ±	particle
puotua	pulverizes
puqcoe	forks
puqgaÄ±no	multimodal
puqmaÄ±	polyamorous
puqmeame	multiset
puqmuÄ±	polysemous
puqneoqsuq	you all
puqsuq	y'all
puqtoeq	and
puqtÄ±q	polyomino
purÄ±my	Purim
pusho	(time) passes
putaokuq	meant to say
putuqhua	Putunhua
putuqzu	Mandarin Chinese
putÄ±q	poutine
puÄ±chao	bus
puÄ±daome	database
puÄ±gÄ±qcuesÄ±o	Oligarchy
puÄ±hÄ±aq	scarce
puÄ±jeqda	polygender
puÄ±m	ink
puÄ±mÄ±a	abundant
puÄ±mÄ±eq	is counting
puÄ±mÄ±eqche	teller
puÄ±ruaÄ±joaq	emperor
puÄ±seu	large number
puÄ±seu	integer
puÄ±sono	few
puÄ±tao	multitasks
puÄ±toa	quantifier
pyÄ±	annoyed
pyÄ±he	irritable
pyÄ±kuq	says complaint
pÄ±afu	neice
pÄ±anete	planet
pÄ±aosaÄ±saÄ±	(a) plastic
pÄ±aozÄ±u	complex number
pÄ±aq	feels surprised
pÄ±aqsuaÄ±	occurs suddenly
pÄ±ca	pizza
pÄ±caloqhÄ±ao	pizza-burns
pÄ±dufodaozu	PDF file format
pÄ±dufokao	PDF file
pÄ±ebÄ±ao	tipsy
pÄ±echuo	straw
pÄ±edoa	adds to beverage
pÄ±ehaq	beverage
pÄ±ejaq	gulps down
pÄ±enao	potable water
pÄ±erogÄ±	pierogi
pÄ±erÄ±o	air one breathes
pÄ±etuao	sips
pÄ±etÄ±ao	potable
pÄ±heq	bladder
pÄ±heqpoke	hooded seal
pÄ±ka	instantaneous
pÄ±kafa	teleports
pÄ±kafachuo	teleporter
pÄ±kea	spruce tree
pÄ±kou	pickle
pÄ±koutoese	pickle slice
pÄ±ku	picrew
pÄ±kuaÄ±	has to pee
pÄ±la	nail
pÄ±lachuo	hammer
pÄ±ma	pepper
pÄ±masaÄ±	capsaicin
pÄ±nu	pine tree
pÄ±nuguele	pineal gland
pÄ±o'anÄ±	gravel
pÄ±ocoesaÄ±	cement
pÄ±oduao	hard candy
pÄ±odÄ±u	geology
pÄ±odÄ±u	petrology
pÄ±ofuaq	statue
pÄ±ohoe	planet
pÄ±ojuju	kilpspringer
pÄ±okaro	mountain goat
pÄ±oloha	lithium
pÄ±omuoq	made of stone
pÄ±omÄ±q	lithosphere
pÄ±onaosaÄ±	lava
pÄ±onulÄ±	petroleum
pÄ±opÄ±u	shell
pÄ±osaÄ±dÄ±u	mineralogy
pÄ±osÄ±u	solid
pÄ±otoekea	stonecutter
pÄ±otuaÄ±	coral
pÄ±pa	pepper
pÄ±q	pings
pÄ±qceo	pixel
pÄ±qda	peanut
pÄ±qdadashÄ±	peanut butter
pÄ±qhÄ±o	pings
pÄ±rÄ±fuÄ±	irritable
pÄ±rÄ±kuq	says complaint
pÄ±rÄ±le	irritable
pÄ±saÄ±	urea
pÄ±uchÄ±q	louse
pÄ±ucÄ±u	sweats
pÄ±unao	sweat
pÄ±unua	peels
pÄ±unuamy	peeler
pÄ±ushoaÄ±	colugo
pÄ±ydÄ±e	shills
pÄ±zÄ±	annoyed
ra'ehaq	roe deer
ra(sÄ±u)choatoaÄ±	rhotic sound
radÄ±ojuqkea	radio receiver
radÄ±osuy	radio wave
radÄ±um	radium
raga	feels energetic
ragacÄ±a	tired
ragoq	strawberry plant
ragoq	argon
ragoqzeo	strawberry fruit
raku	Toaq-syllable
rakygÄ±aq	rock music
ram	RAM
ramadaq	Ramadan
ramanabamÄ±	Rama Navami
ramchÄ±u	pointer
rameq	ramen
rameq	ramen
raogÄ±	timely
raojeq	is concurrent
raojoaÄ±	attempts to date
raojuÄ±	temporally close
raojÄ±oq	dates
raoleo	intends to do
raomÄ±eq	dates
raqbo	pertains
raqbuÄ±	off-topic
raqchÄ±e	learns subject
raqcua	responds to
raqcuachue	forum thread
raqdeoq	talks with
raqdua	is familiar
raqdÄ±o	wren
raqfeao	worries about
raqjuoÄ±	describes
raqkueme	bibliography
raqkuq	comments on
raqkuqsue	asks
raqme	semantic frame
raqpoe	unrelated
raqraq	tangentially
raqse	topic
raqsu	bronze
raqsÄ±aruaq	renounces
raqtaq	meta
raqtoa	thematic
raqzaruse	content warning
rarasaÄ±	unobtainium
rasu	skin rash
ratajata	Ratha Yatra
rato	rat
raÄ±dÄ±u	ontology
raÄ±foa	feeling
raÄ±hÄ±	is
raÄ±ke	thingy
raÄ±laqteÄ±	falling tone
raÄ±luo	set
raÄ±toa	noun
raÄ±toame	noun phrase
raÄ±toateÄ±	noun case
raÄ±tue	state
reahuashoaÄ±	colugo
reahueq	entire surface
reame	surface
reamuÄ±	straight
reaq	lies
reaqruoq	horizontal
reaqshua	falls laterally
reaqsofa	reclining couch
reatuq	is all contained
reatÄ±	at the edge
reaÄ±muo	antithesis
reaÄ±toÄ±	opposes
rebo	**rÃ©**'s
regochÄ±u	Gregorian date
regonÄ±aq	Gregorian year
rem	surface
remtÄ±	at
reocuaq	colour
reoge	color
reohua	iris
reokaÄ±	writes
reomÄ±a	many-coloured
reoqchuq	eats dinner
reoqfeo	west
reoqlÄ±o	south
reoqsÄ±aq	north
reosaÄ±	paint
reotuaÄ±	chromosome
reqde	attractive
reqdÄ±u	anthropology
reqgaq	fellow human
reqkea	android
reqkÄ±bucÄ±abÄ±so	HIV
reqmy	humanoid doll
reqpapybeqsebÄ±so	HPV
reqpoqgaq	headmate
reqse	artificial
reqsesaÄ±	plastic
rere	lily
rerÄ±saÄ±	hallucinogenic
reu	=
reu	product
reume	product of all
reupaq	divisor
reÄ±duy	orbits
reÄ±fuq	skirt
reÄ±jÄ±aq	environment
reÄ±jÄ±oqchuo	abacus
reÄ±kueq	gather around
reÄ±muoÄ±	revolves
reÄ±my	ring
reÄ±nuao	arches over
reÄ±shaha	game Go
reÄ±sho	dissolves in
reÄ±shuaq	emits
reÄ±soÄ±	Go
reÄ±taq	coiled up
reÄ±taqpeq	scroll
reÄ±taqteÄ±	spiral
reÄ±to	ritual
roachÄ±aÄ±	â€œjust not rightâ€
roacoaq	domesticated
roacuao	supernatural
roadeaq	ground
roadue	â€œsimply rightâ€
roagÄ±q	artificial
roanÄ±aÄ±	beast
roao	decorates
roaqdeqbu	infertile
roaqfu	half-sibling
roaqgulaq	gonad
roaqpÄ±a	aunt
roaqpÄ±afu	cousin
roaqseo	step-parent
roaqseofu	step-sibling
roaruodÄ±u	ethology
roarÄ±aq	natural habitat
roateu	= exp
roazu	natural language
roazÄ±u	natural number
roaÄ±jue	August
roaÄ±kata	eight
roaÄ±laqteÄ±	eighth tone
roaÄ±peoq	oxygen
roaÄ±pue	octopus
rochoa	raven
roeduo'akaÄ±	workout soreness
roehaq	nutritious
roetue	health
rogue	roguelike
rokodelo	crocodile
rom	safe
rommoe	feels safe
romÄ±um	chromium
roq	cries
roqkuaÄ±	wants to cry
roqkuaÄ±ge	tearjerker
roqtoaÄ±	teardrop
roqzeo	onion
roÄ±bu	except
roÄ±me	is
ruabo	has flowers
ruaboe	petal
ruadueq	flower field
ruajua	trippy
ruajualÄ±e	trips
ruajuasaÄ±	psychedelic
rualaÄ±	fleuron
ruameÄ±pÄ±o	granite
ruamÄ±a	in bloom
ruanhuo	bouquet
ruanÄ±aÄ±	anthozoan
ruaomÄ±a	forgiving
ruaqcheu	tells lie
ruaqgÄ±	sincere
ruaqmea	presupposed
ruaqruaq	reports
ruaqse	assertion
ruaqshao	meant to declare
ruashuaq	blooms
ruaÄ±bue	palace
ruaÄ±cha	done in a noble
ruaÄ±fua	throne
ruaÄ±gua	kingdom
ruaÄ±guame	empire
ruaÄ±joaqchuaq	monarchism
ruaÄ±jÄ±o	castle
ruaÄ±kata	jack
ruboq	omits doing
rubÄ±	ruby
ruchÄ±a	Confucian
ruco	asserts
rudo	bramble
ruechoakuq	whispers
ruedea	taps
rueduagÄ±	clue
ruekoÄ±	walks timidly
ruelaq	sonorant
ruenuo	dozes
ruenuoÄ±	nibbles at
rueqduoÄ±	becomes pent up
rueqduy	twitches
rueqmoe	stressed out
ruereo	dull in color
rugo	and
rujÄ±	cream
ruka	back
rukacea	backpack
rukalÄ±aÄ±	swims backstroke
rukatuÄ±my	saddle
rulaÄ±	ampersand
rumu	is, with
ruochua	name
ruodoa	entrusts
ruodoetua	manipulates
ruogÄ±nÄ±aÄ±	saola
ruohuÄ±	(agent) is rude
ruohuÄ±	untactful
ruojeq	redundant
ruojuao	policy
ruojuq	assumes role
ruolua	theatrical play
ruoluaq	pretends to be
ruome	ecosystem
ruonua	replaces
ruoqgaoduochao	helicopter
ruoqteÄ±	orthogon
ruoqteÄ±tu	orthogonal
ruoqtuaq	oryx
ruotÄ±ao	acts according
ruoÄ±ceaqpoke	Weddell seal
ruoÄ±gÄ±a	cord
ruoÄ±kuaÄ±	has anorexia
ruqfuq	raincoat
ruqhÄ±eq	scolds
ruqleoq	umbrella
ruqnuam	rainbow
ruqnuaoreo	rainbow-colored
ruqpÄ±o	meteor
ruqshÄ±q	petrichor
ruqtoaÄ±	raindrop
rurÄ±	stands in
rurÄ±gÄ±	occurs on behalf
rurÄ±laÄ±	is a tag
ruÄ±depÄ±	Risso's dolphin
ruÄ±fubuche	common duiker
ruÄ±hupÄ±	gray fox
ruÄ±kaÄ±	pencil
ruÄ±keto	gray whale
ruÄ±musela	grison
ruÄ±poke	gray seal
ruÄ±she	clearly
ryaq	colour orange
rÄ±achoatoaÄ±	vowel
rÄ±aogÄ±o	crepuscular rays
rÄ±aqcÄ±a	deserted
rÄ±aqgÄ±u	strip
rÄ±arÄ±aq	square
rÄ±aÄ±bo	is supported by
rÄ±aÄ±ceaq	hoof
rÄ±aÄ±he(kea)	frame
rÄ±aÄ±hua	neck
rÄ±aÄ±huafuq	scarf
rÄ±aÄ±my	support
rÄ±aÄ±mypuefuq	platform boots
rÄ±aÄ±pÄ±o	bedrock
rÄ±aÄ±rÄ±ochao	hovercraft
rÄ±aÄ±saÄ±	protein
rÄ±egoa	is the space
rÄ±ejeqda	intergender
rÄ±ekoaÄ±	Internet
rÄ±eqcÄ±oq	Esc (Escape) key
rÄ±eqgÄ±q	embraces
rÄ±eqjara	flees
rÄ±eqjara	flees
rÄ±eqkueq	pile(s) up
rÄ±eqsoa	saves
rÄ±hÄ±	rice
rÄ±juru	marmot
rÄ±o'aÄ±	unperceived
rÄ±obÄ±u	tornado
rÄ±obÄ±u	trachea
rÄ±oce	airport
rÄ±ocholÄ±chao	hovercraft
rÄ±ocholÄ±meaq	hovercraft
rÄ±ocÄ±u	belches
rÄ±oguÄ±	popcorn
rÄ±ohua	lung
rÄ±ojuju	air-jumps
rÄ±okÄ±oq	balloon
rÄ±okÄ±oqcÄ±e	pufferfish
rÄ±olÄ±aÄ±	flies
rÄ±olÄ±aÄ±	flies
rÄ±omÄ±q	athmosphere
rÄ±omÄ±q	atmosphere
rÄ±onao	dew
rÄ±onaomaÄ±	fruit fly
rÄ±opÄ±e	breathes in air
rÄ±oqbaq	default
rÄ±oqbo	has subtype
rÄ±oqdÄ±u	typology
rÄ±oqjeqchuq	cannibal
rÄ±oqjuoÄ±	narrows down
rÄ±oqmea	belongs to type
rÄ±oqpÄ±a	version
rÄ±oqrÄ±oq	subcategory
rÄ±osho	evaporates
rÄ±osÄ±qkoaÄ±	air filter
rÄ±oÄ±gÄ±	occurs
rÄ±oÄ±sÄ±acuetaq	direct democracy
rÄ±oÄ±tao	does
rÄ±q(de)pÄ±o	emerald
rÄ±qchaÄ±	green tea
rÄ±qkuao	of color
rÄ±qkuao	of color
rÄ±qnao	bile
rÄ±qnaokusu	honeydew melon
rÄ±qpÄ±o	emerald
rÄ±qzao	greens
rÄ±ukuq	replies
rÄ±usoÄ±	revenges on
rÄ±usÄ±aÄ±bÄ±u	vein
rÄ±utao	does
rÄ±utua	resets
rÄ±utue	anniversary
rÄ±y	gas
rÄ±ygÄ±okeatao	gaslights
sa'u	false
sabeka	elder
sabÄ±ety	soviet
sabÄ±toa	is a determiner
safÄ±ra	sapphire
saharagazala	Saharan gazelle
sahu	false
sahuruaq	tells lie
sajabu	nonpredicate
sajeq	and
saka	shirt
sake	sakÃ©
sakura	sakura
sakurazeo	cherry
sakyso	saxophone
sala	expands
salata	pirate
salÄ±cy	willow
samara	samara
samuraÄ±	samurai
sao'alaÄ±	seaweed
saobeaq	staff
saochao	truck
saochÄ±e	university
saochÄ±eche	university
saofa	travels
saohuohuanuÄ±	Steller sea lion
saojaq	huge
saojÄ±oruaÄ±	pharaoh
saokaro	takin
saokaÄ±	writes
saokua	hall
saokÄ±ao	gate
saokÄ±ao	gate
saolaÄ±	capital letter
saoleohe	ambitious
saomeÄ±	mountain
saomo	salmon
saomÄ±e	beast
saonaomusela	giant otter
saone	physical size
saope	size ratio
saopokesao	Dall's porpoise
saopoq	tall person
saopue	kangaroo
saoro	reptile
saorokato	jaguarundi
saoronuao	sauropsid
saosa	sauce
saose	celebration
saosuhu	giant forest hog
saoteq	buys
sapabuo	is willing to do
saqboe	clover
saqdukata	SD card
saqdÄ±	sandhi
saqguao	trident
saqja	ternary relation
saqjue	March
saqjÄ±eq	triangle
saqkata	three
saqlaq	goofy
saqlaqteÄ±	third tone
saqlaqteÄ±	third tone
saqmotao	triangulates
saqpaq	one third
saqpeoq	lithium
saqsheaq	testicle
saqsheaqcea	scrotum
saqsu	whispers
saqtÄ±q	triomino
saraq	is associated
saraÄ±mÄ±u	quantifier
saro	skirt
sasa	moth
satoa	determiner
saÄ±bÄ±ao	intoxicated
saÄ±cha	physical
saÄ±chuq	ingests
saÄ±cuao	transcendent
saÄ±dÄ±u	chemistry
saÄ±jueq	stirs
saÄ±ku	Discord server
saÄ±me	is a mix
saÄ±moaq	stain
saÄ±moaqmefÄ±tÄ±	spotted skunk
saÄ±po	soap
saÄ±rea	surface
saÄ±roq	iron
saÄ±rue	weak
saÄ±rÄ±oq	kind of stuff
saÄ±sÄ±a	immaterial
saÄ±toaÄ±	molecule
seaba	Shabbat
seachaq	holiday
seachaqchue	holidays
seaha	yawns
seajaÄ±	feels relieved
seakoÄ±	goes on a walk
seamoe	feels relaxed
seaqche	sex worker
seaqchoaqjÄ±o	love hotel
seaqchuq	vores
seaqcÄ±a	virgin
seaqde	attractive
seaqdÄ±u	sexology
seaqfuaq	pornographic
seaqge	attractive
seaqgoaÄ±	grinds on
seaqhuarÄ±oq	sex
seaqjaÄ±	sexually aroused
seaqkea	sex toy
seaqkÄ±oq	testicle
seaqkÄ±q	porn
seaqmy	jizz
seaqmÄ±a	promiscuous
seaqnuo	has a wet dream
seaqpeobÄ±a	has an STD
seaqrÄ±eq	celibate
seaqtaq	masturbates
seaqtuaÄ±	sex doll
seaÄ±	wine
seaÄ±bÄ±ao	drunk on alcohol
seaÄ±jÄ±o	bar
seaÄ±rÄ±aq	bar
seaÄ±shea	sober
seaÄ±sho	ferments
sebo	carries result
seceÄ±la	off the ball
sedu	hiccups
seguaÄ±	does commission
sekuqdÄ±aqne	hertz
sekÄ±	seki
selaq	shark
selenÄ±um	selenium
semÄ±o	means
seo(sho)sue	asks to marry
seonue	fiancÃ©
seoq(gaÄ±)chuo	telescope
seoqceoq	lightning bolt
seoqceoqbeaq	lightning rod
seoqchuaÄ±	comet
seoqcuao	outer space
seoqcuaodÄ±u	astronomy
seoqcuaomÄ±e	extraterrestrial
seoqdÄ±u	astronomy
seoqhÄ±u	Milky Way
seoqjeoq	Heaven
seoqkasÄ±	walnut tree
seoqlaq	thunder
seoqlaqbeaq	gun
seoqlaqbÄ±u	gun
seoqlÄ±aÄ±	flies
seoqmeaq	aircraft
seoqmÄ±o	sky-blue
seoqmÄ±orua	azure bluet
seoqpÄ±o	asteroid
seoqpÄ±o	meteorite
seoqraq	celestial
seoqreo	sky blue
seoqtuedÄ±u	meteorology
seoqzuru	lightning
seosho	marries
seotue	wedding
sepa	astringent
sepe	snake
sepo	snake
seqju	snail
seqtaku	forgives
sesÄ±u	degree Celsius
setuq	is the codomain
seudueq	spreadsheet
seuhuaqjeq	â‰¥
seujeqhuaq	â‰¥
seukoaÄ±	number sieve
sey	number
shabu'oty	Shavuot
shachoa	hisses
shagÄ±q	leaves
shahache	chess player
shahahÄ±eq	knight
shahajoaq	king
shahalÄ±a	bishop
shahameoq	pawn
shahapoq	chess piece
shahasheaq	rook
shahasuaÄ±	queen
shahÄ±ena	Cheyenne
shalÄ±	has a low mass
shamaq	shaman
shana	menstruates
shanajue	menstrual cycle
shanapÄ±u	endometrium
shao'achoqte	is burnt out on
shaoboq	demotivates
shaobuaq	wanted to do
shaobutao	does
shaoca	motivates
shaoge	motivation
shaogÄ±	virtuous
shaohuÄ±	sinister
shaohÄ±aq	lazy
shaojao	wants to avoid
shaojuÄ±	attracted
shaoluÄ±tÄ±ao	satisfactory
shaomoe	is willing to do
shaomuÄ±	intended meaning
shaomÄ±a	eager
shaqbara	rusa deer
shaqbeq	cheek
shaqduo	advances
shaqfa	proceeds
shaqfeo	north direction
shaqhua	Ä±s a face
shaqkÄ±a	blushes
shaqpaq	front
shaqsheaq	prostate
shaqsoq	primate
shaqtoa	preposition
shaqtÄ±a	inside-out
shaqtÄ±e	face mask
shaqzÄ±u	positive number
shata	disposes of
shatatÄ±aÄ±	trash bin
shaÄ±chey	scams
shaÄ±deqtao	abnegates
shaÄ±duo	stops moving
shaÄ±kÄ±ao	exit
shaÄ±sÄ±a	true always
sheabÄ±a	has depression
sheabÄ±afoa	depression
sheagoa	space
sheaguaq	wasteland
sheakoÄ±	wanders
shealaÄ±	space
shealaÄ±cÄ±oq	space bar
sheameame	empty set
sheamoe	feels empty
sheamuoq	ether
sheamÄ±	outer space
sheamÄ±'araÄ±	celestial body
sheamÄ±chao	spaceship
sheamÄ±puo	cosmic dust
sheamÄ±q	outer space
sheaq	stands on
sheaq	stands
sheaqcÄ±oq	pressure plate
sheaqfua	step-stool
sheaqmÄ±	rook
sheaqnuoq	upside-down
sheaqnuÄ±	short
sheaqruoq	vertical
sheaqsao	tall
sheaqshua	collapses
sheaqtuÄ±fua	stool
sheasaÄ±	ether
shechÄ±aq	intuits
shedoa	offers that he
shedoa	offers
shejuoÄ±	defends
shemoÄ±	intuits
shenue	promises to do
sheokuq	apologizes
sheomÄ±a	apologetic
sheq	sword
sheqloha	steel
sheqly	razor
sheqpoq	swordsperson
shetoa	modal verb word
shetuq	iff
sheÄ±daq	free time
sheÄ±duq	has hobby
sheÄ±fuq	casual clothing
sheÄ±ga	immortal
sheÄ±gadÄ±u	Life & Death
sheÄ±gÄ±qpoq	prisoner
sheÄ±moÄ±	freethinks
sheÄ±moÄ±he	freethinker
sheÄ±tua	liberates
shoanuo	sleeps deeply
shoaÄ±'eku	winged horse
shoaÄ±'eku	winged horse
shoaÄ±bo	winged insect
shoaÄ±cÄ±aloekÄ±mÄ±	firebug
shoaÄ±cÄ±apahukorÄ±	firebug
shoaÄ±cÄ±arÄ±ochao	boat
shoaÄ±heku	winged horse
shoehuao	lean
shoesue	asks
shoju	soy sauce
shojufaseo	soy beans
shojunao	soy sauce
shoÄ±gÄ±aq	screamo
shoÄ±kune	coyote
shoÄ±laq	scream
shoÄ±se	cry
shu'u	birdie
shuacaoboe	autumn leaves
shuaobue	bird nest
shuaokÄ±aq	feather
shuaqfaqme	process
shuaqhua	gland
shuashoe	lets
shuaÄ±bÄ±o	glass
shuaÄ±juao	rule of thumb
shuaÄ±mÄ±u	thinks earnestly
shucu	squishes
shue	remains the case
shuedama	stable
shuedaqbuaÄ±	abiding
shueduÄ±	goes on and on
shuehuÄ±cea	garbage bag
shuemy	remains
shuepaq	what's left
shueqlue	mustard
shuereu	yields remainder
shunha	number zero
shuofua	closet
shuokaÄ±	notes
shuomÄ±a	supermarket
shuonÄ±u	succulent
shuosÄ±a	void
shuotao	saves
shurÄ±keq	shuriken
shuÄ±	secret
shuÄ±'Ä±um	krypton
shuÄ±cÄ±a	has open
shuÄ±gÄ±qkuq	admits
shuÄ±hÄ±eq	nosy
shuÄ±juq	accesses
shuÄ±luakuq	spoils
shuÄ±ruo	acts stealthily
shuÄ±sÄ±	lurks at
shuÄ±sÄ±	spies on
shuÄ±sÄ±che	spy
shuÄ±sÄ±o	idea of privacy
shuÄ±toa	password
shuÄ±tua	encrypts
shuÄ±tÄ±	is hidden at
shuÄ±zua	reveals
shuÄ±zÄ±u	key
shykaÄ±	signs
shylaÄ±(me)	password
shÄ±'aÄ±	united
shÄ±aboe	glass pane
shÄ±ao	disappears
shÄ±aqbea	knee
shÄ±aqbÄ±u	pantyhose
shÄ±aqfuq	pants
shÄ±aqgao	leggings
shÄ±aqgÄ±e	member
shÄ±aqmuao	mangrove tree
shÄ±aqmÄ±a	myriapod
shÄ±aqtÄ±e	legging
shÄ±bu	not the case
shÄ±caqche	dictator
shÄ±caqchuaq	dictatorship
shÄ±chaqshoaÄ±	mayfly
shÄ±chuaobo	monotreme
shÄ±chuetÄ±eq	monorail
shÄ±chuoÄ±	thread
shÄ±chÄ±eqlaÄ±	letter X
shÄ±cuaq	property
shÄ±ebo	wakeful
shÄ±egaÄ±	daydreams
shÄ±ejÄ±aq	waking world
shÄ±elaq	wake-up alarm
shÄ±ene	â€˜dayâ€™
shÄ±esho	wakes up
shÄ±eshua	passes out
shÄ±geo	primordial
shÄ±hea	connected
shÄ±ho	him
shÄ±ja	is the property
shÄ±jue	January
shÄ±jue	January
shÄ±kaqpoa	winks
shÄ±kata	ace
shÄ±ko	is first among
shÄ±koe	has only got
shÄ±kogÄ±q	is last among
shÄ±kotao	done firstly
shÄ±kuqse	monologue
shÄ±laqteÄ±	first tone
shÄ±my	xâ‚
shÄ±mÄ±edaosaÄ±	RNA
shÄ±na	gas
shÄ±napÄ±anete	gas giant
shÄ±paq	whole
shÄ±qbo	emits
shÄ±qboqlaq	nasal stop
shÄ±qbÄ±ru	rhinovirus
shÄ±qbÄ±so	rhinovirus
shÄ±qcey	sniffs
shÄ±qchoa	snorts
shÄ±qchuao	nostril
shÄ±qdao	smell
shÄ±qde	smells beautiful
shÄ±qdenao	perfume
shÄ±qge	has smell
shÄ±qgÄ±	smells good
shÄ±qhuagoaÄ±fuq	handkerchief
shÄ±qhuaguy	handkerchief
shÄ±qhuahuaÄ±	picks their nose
shÄ±qhuahuaÄ±	picks their nose
shÄ±qhualapÄ±sÄ±u	rhinoceros
shÄ±qhuatuaqsÄ±u	rhinoceros
shÄ±qhuÄ±	smells bad
shÄ±qjeoq	nasal cavity
shÄ±qnao	perfume
shÄ±qnaotÄ±aÄ±saÄ±	alabaster
shÄ±qnuasaÄ±	deodorant
shÄ±qsaÄ±	fragrance
shÄ±qsÄ±u	smells like
shÄ±qto	Shinto
shÄ±raq	specific
shÄ±reÄ±	cryptid
shÄ±sha	shisha
shÄ±shecheo	distributive
shÄ±suao	unique
shÄ±tuaq	unicorn
shÄ±ubuaq	attempts to do
shÄ±ucoetoa	prefix
shÄ±ucuo	presupposes
shÄ±ufa	goes
shÄ±ujuÄ±	shortly before
shÄ±ukune	raccoon
shÄ±ukÄ±e	thanks
shÄ±uleo	tries to do
shÄ±uleo	intends to do
shÄ±unao	pre-ejaculate
shÄ±utao	does
shÄ±utaÄ±	does
shÄ±utoÄ±	treats
shÄ±y	disappears
soaboq	prevents
soabuaq	does
soacha	done with help
soacokÄ±	charity
soafuaÄ±	charity
soagÄ±q	unhelps
soahÄ±ao	hurts
soakaÄ±se	guide
soakune	service dog
soaqkÄ±aÄ±che	gardener
soaqpao	gardens
soaqpaoche	gardener
soasue	asks
soatoa	particle
soatoarÄ±oq	particle
soaÄ±ca	emits rays
soaÄ±dÄ±eq	beams
soaÄ±gÄ±a	cord
soaÄ±shoaÄ±	Actinopterygii
soaÄ±shuaq	radioactive
soaÄ±tao	extends
sodÄ±um	sodium
soezeo	lemon
sofa	sofa
soke	citric
soke'acÄ±	citric acid
sona	circle
sono'acÄ±	weak acid
soqbo	sows
soqcho	likes
soqja	sponge
soqjapÄ±o	tuff
soqjuÄ±	is extremely
soqkuoÄ±	satisfies with
soqmea	majority
soqmoa	climax
soqnedaq	limited in time
soqrÄ±aq	utopia
soqsÄ±q	hygienic
soqtoÄ±	does
soresÄ±u	shrew
sorÄ±	sews
sosuogoÄ±che	EMT
souleÄ±	ex forma
soy	vegan
soy	circle
soypaq	semicircle
soÄ±buaq	loses to
soÄ±buaq	loses to
soÄ±che	soldier
soÄ±cheme	army
soÄ±chu	is at odds with
soÄ±cÄ±a	is at peace with
soÄ±dueq	battlefield
soÄ±fuaÄ±	military
soÄ±goeq	battlement
soÄ±heo	is against
soÄ±huaq	wins
soÄ±luaq	compete against
soÄ±me	army
soÄ±muo	wars with
soÄ±paÄ±	rival
soÄ±ruo	act of violence
soÄ±tue	battle
suacÄ±a	pointless
suaobukuaq	shrugs
suaochua	title
suaochÄ±duÄ±taq	megalomaniac
suaojaqchÄ±taq	megalomaniac
suaojÄ±etÄ±ao	worth esteem
suaomoe	cherishes
suaopaÄ±	close
suaose	celebration
suaosoq	priority
suaotuao	unimportant
suaotuaomÄ±u	despises
suaq	sings
suaqgÄ±aq	song
suaqse	song
suaqsue	prays
suaqsuese	prayer
suatao	depends on
suaÄ±(mÄ±eq)chuo	speedometer
suaÄ±ca	speeds
suaÄ±daÄ±ne	top speed
suaÄ±fafa	pursues
suaÄ±furÄ±	shakes
suaÄ±haq	fast food
suaÄ±haqche	fast food worker
suaÄ±koÄ±luaq	play tag
suaÄ±luaq	speedruns
suaÄ±mÄ±	queen
suaÄ±peq	reference sheet
suaÄ±sÄ±umoÄ±	intuits
suaÄ±tao	hurries
suaÄ±tao	hurries up
suaÄ±taobu	takes his
suecaq	commands
suecaÄ±	demands
suecua	obeys
suecuahe	obedient
suedo	sweat
suedocÄ±u	sweats
suefa	goes on a quest
suejaq	exhorts
sueq	wave
suetao	does what
suhu	typical pig
suhugÄ±a	bacon
suhukenobo	babirusa
suhulÄ±q	striped hyena
suhulÄ±qsÄ±u	hyena
suhumelÄ±	hog badger
suhunueq	pork
suhunuÄ±	pygmy hog
suhusÄ±u	pig
suku	different
sumake	sumac
sumo	sumo wrestling
sune	weaves
suo	you
suoqsuoq	grandchild
suoÄ±	is great
suoÄ±hÄ±aotue	(great) disaster
suoÄ±jaq	extremely
suoÄ±pulua	legend
suoÄ±sao	gigantic
supaq	spam
supaqkaÄ±(doa)	spams message
suqdaq	your now
suqde	you, cutie
suqnaÄ±	your now
suqneoq	you
suqpa	satisfied by you
suqrÄ±aq	your location
suqtuq	yâ€™all
surÄ±kata	meerkat
surÄ±q	syrinx
sushÄ±	sushi
susÄ±	swings
susÄ±gÄ±aq	swing music
suty	suit
suy	wave
suyduy	undulates
suzÄ±	spiral
suÄ±huaq	satisfies with
suê¡e	wave
suê¡efa	surfs
suê¡erÄ±e	oscillates
suê¡etoq	surfboard
suê¡ezÄ±a	pulses
sÄ±a'anouhe	aromantic
sÄ±achuaq	nihilism
sÄ±ahÄ±ao	benefits while
sÄ±aja	proposition
sÄ±alaÄ±	digit zero
sÄ±ame	empty aggregate
sÄ±aosuao	is a basis
sÄ±aotoa	incipit
sÄ±aotu	original
sÄ±apeÄ±	number zero
sÄ±aqfeo	east direction
sÄ±aqmuq	right hand
sÄ±aqmuqpoq	right-handed
sÄ±aqpaq	right part
sÄ±aseu	number zero
sÄ±atuaq	royal antelope
sÄ±azÄ±u	number zero
sÄ±aÄ±bÄ±u	blood vessel
sÄ±aÄ±cÄ±u	bleeds
sÄ±aÄ±hua	heart
sÄ±aÄ±jaq	gory
sÄ±aÄ±koaÄ±	vascular system
sÄ±aÄ±kÄ±a	blood-red
sÄ±aÄ±loaÄ±sÄ±u	hemorrhoids
sÄ±aÄ±loha	iron
sÄ±aÄ±lue	blood plasma
sÄ±aÄ±mÄ±eq	tests blood
sÄ±aÄ±pÄ±e	vampire
sÄ±aÄ±zÄ±e	hormone
sÄ±beo	distracted
sÄ±bu	ignores
sÄ±buaq	ignores
sÄ±buaqdaÄ±sÄ±	experiences FOMO
sÄ±buaqtea	experiences FOMO
sÄ±chuq	distracts
sÄ±dÄ±heqmy	CD rack
sÄ±ebaq	list
sÄ±edao	sequence
sÄ±eho	is
sÄ±ehoq	following
sÄ±ehoÄ±	is
sÄ±ejara	chases after
sÄ±ekao	will
sÄ±ekaÄ±se	afterword
sÄ±ekÄ±q	sequel (movie
sÄ±elu	following
sÄ±emaq	is
sÄ±eme	sequence
sÄ±eme	sequence
sÄ±emenuoq	is the mirrored
sÄ±eqchue	rollercoaster
sÄ±eqde	numinous
sÄ±eqdoa	initiates
sÄ±eqge	amazing
sÄ±eqgÄ±	great
sÄ±eqsuoÄ±	miraculous
sÄ±eqtue	miracle
sÄ±etao	takes next step
sÄ±fÄ±ususÄ±u	beaked whale
sÄ±gÄ±	interesting
sÄ±he	is a
sÄ±ja	attracts
sÄ±jou	focuses on
sÄ±ju	polices
sÄ±juche	police officer
sÄ±jucokÄ±	policing system
sÄ±ka	Sikh
sÄ±kuaÄ±	is curious about
sÄ±kÄ±	ski
sÄ±la	thread
sÄ±lÄ±koq	silicon
sÄ±moe	feels focused
sÄ±muo	meditates
sÄ±ne	sine
sÄ±nu	= sin
sÄ±oge	evokes
sÄ±ogÄ±	conceptually
sÄ±ojuq	gets idea
sÄ±oqchao	wheeled vehicle
sÄ±oqduo	runs
sÄ±oqpuao	cyclone
sÄ±oqteÄ±	circle
sÄ±pua	amused
sÄ±puache	entertainer
sÄ±puatua	entertains
sÄ±puatuache	entertainer
sÄ±qgoaÄ±	wipes
sÄ±qguy	wash cloth
sÄ±qhua	kidney
sÄ±qjeoq	bathtub
sÄ±qmuo	spotless
sÄ±qpeq	toilet paper
sÄ±qsaÄ±	detergent
sÄ±qtua	cleans
sÄ±qtuachuaq	hygiene
sÄ±rÄ±	silk
sÄ±rÄ±laÄ±	Cyrillic letter
sÄ±sa	conscious
sÄ±shaÄ±	leaves
sÄ±sue	calls
sÄ±sÄ±a	unconscious
sÄ±tako	parrot
sÄ±tua	notifies
sÄ±ugÄ±q	dissimilar
sÄ±ukaronuÄ±	pygmy antelope
sÄ±uruo	mimics
sÄ±yky	treads
ta'Ä±	taxi
tabako	tobacco
tage	= tan
tagÄ±	accidentally
tagÄ±moaq	has a flashback
tajÄ±kao	are instructions
tajÄ±zao	knows how to do
takumuÄ±	intended meaning
takÄ±	Takis
tamaohaq	tamale
tana	mesh
tano	soil
tanoloha	aluminium
tanukÄ±	raccoon dog
tanÄ±	stem
tanÄ±tÄ±e	bark
taoca	(0) motivates
taocaÄ±	strong-willed
taocho	likes
taochÄ±	plans
taochÄ±fea	remembers to do
taochÄ±moaqshaÄ±	forgets to do
taochÄ±shaÄ±	forgets to do
taodÄ±eq	sends
taodÄ±etaÄ±	convinces
taofa	goes to do
taogaq	partner
taogaq	and
taogaqme	team
taoguo	activity
taogÄ±q	accidentally
taogÄ±qloaÄ±shua	spills
taohÄ±ao	attacks
taojao	is off
taojuoqtao	does their dues
taokakoe	decides to do
taoko	planner
taokoe	chooses
taokokaÄ±	schedules
taomana	"energy"
taomoaq	remembers to do
taomudaÄ±	property
taomuo	completes task
taomy	stamina
taomÄ±a	busy
taomÄ±y	team
taonhuo	is a schedule
taonue	promises to do
taopa	accepts
taopaqme	project
taorue	timid
taosapa	accepts
taose	something done
taoshaokao	planner
taotua	fools
taotÄ±ao	is in
tapy	taps
tapÄ±oka	tapioca
tapÄ±okakÄ±oq	tapioca pearl
tapÄ±ra	tapir
taqbu	taboo
taqchÄ±aq	self-aware
taqfoto	selfie
taqfuaq	selfie
taqgaÄ±	senses
taqko	account
taqkÄ±butoaÄ±	autoantibody
taqmudaÄ±	relation
taqnuoq	symmetric
taqnuoqteÄ±	fractal
taqpo	is
taqraka	tailless tenrec
taqrakanuÄ±	shrew tenrec
taqrakasÄ±u	tenrec
taqru	tanru
taqtoaq	idiolect
tashÄ±	me
tatoa	adjective
tatu	tattoo
taÄ±caq	happens thanks
taÄ±cha	successful
taÄ±jÄ±q	prospers
teabÄ±a	has a phobia
teaca	scary
teacaÄ±	brave
teafeao	paranoid
teafurÄ±	shudders
teage	scary
teajua	creepy
teakÄ±q	horror movie
teanuoge	nightmare
teapuoq	horror
teaqdoa	breastfeeds
teaqfeoq	aureola
teaqfuq	bra
teaqrÄ±aÄ±fuq	bra
tease	fear
teashuao	giant moa
teasuaÄ±	menace
teasuaÄ±	intimidated
teasuaÄ±melÄ±	honey badger
teatue	emergency
teaÄ±	is averse
tecoteroq	testosterone
tecÄ±	free
tefa	tangled
tefacha	an
tefacoe	intertwined with
tefamy	knot
tenÄ±sÄ±	tennis
teolaÄ±	close-quote
teoqcua	answers question
teoqdue	is an
teoqkudote	interviews
teoqnuateoqdoa	interviews
teoqtÄ±ao	is a valid
teq	pays
teq	pays money
teqboe	coupon
teqchey	sets
teqdoa	sells, for money
teqdoeme	economy
teqfa	visits to trade
teqfuaÄ±	company
teqga	asks question
teqguaÄ±joaq	boss
teqhukÄ±	fines
teqjuq	is payed
teqkea	cash register
teqluaq	plays gambling
teqne	amount paid
teqpeq	paycheck
teqrÄ±kÄ±o	Tenrikyo
teqse	payment
teqsÄ±a	gifts property
teqtekata	pre-paid
teqzÄ±q	credit card
terakota	terracotta
terÄ±o	stale
teshy	lets
tesoseroq	testosterone
tetabo	turtle
tetabokuoq	turtle shell
teu	=
teÄ±baq	idealized shape
teÄ±bo	has shape
teÄ±chuo	pattern
teÄ±cÄ±a	amorphous
teÄ±doafuÄ±	malleable
teÄ±dÄ±u	geometry
teÄ±fuaq	design
teÄ±fuÄ±	soft
teÄ±fÄ±eq	designs
teÄ±gaÄ±	perceives shape
teÄ±gÄ±aÄ±chuo	chisel
teÄ±jeq	is shaped like
teÄ±kuaq	assumes pose
teÄ±noa	hard
teÄ±rea	surface
teÄ±rÄ±uhe	elastic
teÄ±sÄ±oq	circle
teÄ±teÄ±	posture
teÄ±toaÄ±	morpheme
teÄ±toaÄ±	morpheme
teÄ±tue	state
teÄ±zÄ±u	complex number
toabeoq	word root
toabuÄ±	not **toanÄ±e**
toachÄ±eq	crossword puzzle
toadoq	brief
toadua	Toadua
toafÄ±eq	invents word
toahÄ±aq	laconic
toajoe	eloquent
toakasu	grammatical case
toakue	dictionary
toakÄ±u	describable
toalaqteÄ±	word-level tone
toalaÄ±	letter
toalea	rhetoric
toalea	poem
toaluaqse	pun
toame	phrase
toamelaqteÄ±	phrasal
toamuÄ±	has definition
toamÄ±a	verbose
toana	constituent
toanuÄ±	brief
toany	constituent
toapaq	morpheme
toapaqjoq	word root
toapuÄ±	verbose
toapuÄ±tuao	laconic
toaq	Toaq language
toaqbeo	translates
toaqcha	Toaq (Dzu) Way
toaqchaq	Toaq Day
toaqdÄ±u	Toaqology
toaqhÄ±uguaome	Toaq delta
toaqkudote	chat
toaqkuq	says
toaqkÄ±	Toaq Anki Deck
toaqluo	language family
toaqme	Toaq community
toaqmuÄ±	meaning
toaqno	in Toaq
toaqreo	Toaq-colored
toaqrÄ±oqmu	dialect
toaqse	Toaq creation
toaqseÄ±	Toaq text
toaqtoa	Toaq word
toaqtÄ±aojÄ±oq	translates
toaqzuno	in Toaq
toatuq	is the lexicon
toaÄ±'acÄ±	amino-acid
toaÄ±ceo	resumes activity
toaÄ±jeq	average value
toaÄ±koÄ±	steps
toaÄ±nuÄ±	very tiny
toaÄ±shaÄ±	pauses activity
toaÄ±shea	vacuum
toaÄ±tue	activity
tobÄ±q	trusts
toe	cuts
toebeaq	sword
toechuekea	chainsaw
toechuo	axe
toecÄ±rÄ±kea	chainsaw
toedea	(agentive) stabs
toedea	chops
toegoÄ±che	surgeon
toekaÄ±	carves
toenua	cuts
toenÄ±oq	incisor
toenÄ±oqchuo	saw
toepaq	slice of
toeq	and
toeqchuoÄ±	chain
toeqfu	descendant
toeqroaq	forebear
toese	slice
toesy	cod
toete	cut
toetoq	cutting board
toetuao	notches
tofu	tofu
tomaty	tomato
tonameqtue	tournament
tonÄ±nha	La Plata dolphin
tonÄ±nhasÄ±u	La Plata dolphin
toqceaq	plate nail
toqchao	skateboard
toqgam	flat cuboid
toqhua	forehead
toqjÄ±	genderqueer
toqkea	tablet computer
toqloy	pan-fried
toqloyfua	griddle
toqloymy	pan
toqpeq	cardboard
toqpeqtÄ±aÄ±	cardboard box
toqsa	being patient
toqsÄ±	genderqueer
toraq	chest
toraqchuo	stethoscope
torodo	ostrich
toroso	thrush
toubuchuq	omnivore
tounueqchuq	carnivore
tounÄ±uchuq	herbivore
toÄ±chÄ±aÄ±	unethical
toÄ±chÄ±aÄ±	morally
toÄ±chÄ±aÄ±kÄ±eq	abhorrent
toÄ±due	morally
toÄ±duesÄ±o	moral
toÄ±gÄ±	kind
toÄ±jeo	is with
toÄ±leoq	protects
toÄ±me	community
toÄ±mebÄ±atue	epidemic
toÄ±moaq	actively recalls
toÄ±mucuaq	relation
toÄ±mudaÄ±	relation
toÄ±rumu	interacts with
toÄ±shao	wants that
toÄ±sue	asks
toÄ±toa	transitive verb
tuabaÄ±	builds on
tuadue	corrects
tuagÄ±q	undoes
tuahao	sets
tuahuÄ±jÄ±e	blames
tuaja	being courageous
tuakoe	chooses
tuamebo	shares
tuanoba	influences
tuaonu	just the case
tuaonuo	naps
tuaoshaÄ±	pauses doing
tuaosÄ±	peeks
tuaotuao	case to a rather
tuaotuoÄ±	is a nitpick in
tuaq	horn
tuaq	horn
tuaq'eku	unicorn
tuaqboluko	serval
tuaqbosa	European hornet
tuaqbosÄ±u	deer
tuaqketo	narwhal
tuasÄ±a	deletes file
tuaÄ±beo	shape-shifts
tuaÄ±caq	fronting (plural
tuaÄ±dÄ±u	anatomy
tuaÄ±fuq	cloak
tuaÄ±fuq	shirt
tuaÄ±gaq	and
tuaÄ±joq	torso
tuaÄ±joq	torso
tuaÄ±joqfuq	shawl
tuaÄ±nhou	cuddles
tuaÄ±paÄ±	headmate
tuaÄ±rue	physically weak
tuaÄ±shaq	abdomen
tuaÄ±sheÄ±	able-bodied
tuaÄ±suaq	dances
tuaÄ±sÄ±a	immaterial
tuaÄ±toaq	body language
tuerÄ±oq	one mode
tuku	shows
tukue	encyclopedia
tumaÄ±	panromantic
tume	tumor
tune	total amount
tunu	tuna fish
tuoqdekÄ±	scale
tuoqkea	scale
tuoqloha	lead
tuoqlÄ±a	scales
tuoqmy	weight
tuoqne	weight
tuoqnuoboe	weighted blanket
tuoÄ±bo	flawed
tuoÄ±fÄ±eq	finds fault in
tuoÄ±luoqtao	does
tuoÄ±ruaq	points out flaw
tuoÄ±sÄ±	critical
tupa	pot
tuq'aÄ±	complete
tuq'Ä±q	is
tuqcuoÄ±	satisfies with
tuqcy	final outcome
tuqgaÄ±huarÄ±aca	eye-opener
tuqjane	maximal arity
tuqjÄ±aq	universe
tuqjÄ±aqdÄ±u	cosmology
tuqko	is last among
tuqloÄ±	abominable
tuqmaÄ±	pansexual
tuqpaq	comprise
tuqreÄ±	surroundings
tuqsuao	unique
tuqsyteq	tungsten
tuqtuq	stims
turula	troll
turulatao	trolls
turuq	torso, a trunk
turuqko	torso, a trunk
turyqko	torso, a trunk
tusa	and
tusashÄ±	and
tuseaq	pansexual
tutÄ±	omnipresent
tuze	soup
tuzy	soup
tuÄ±fuapuÄ±	stadium
tuÄ±mara	couch
tuÄ±myme	row
tuÄ±nÄ±u	bush
tuÄ±sho	sits down
tuÄ±tea	Twitter
tÄ±afeo	south direction
tÄ±aobeo	adjusts to match
tÄ±aodaq	appropriate time
tÄ±aodoa	assigns
tÄ±aodoajeq	assigns
tÄ±aofoa	satisfied
tÄ±aogÄ±	suitable
tÄ±aojeo	true
tÄ±aokuqse	mot juste
tÄ±aomoe	satisfied
tÄ±aomu	accepts
tÄ±aonuaÄ±	currency
tÄ±aonÄ±e	is snug
tÄ±aotoaÄ±	is a notch
tÄ±aotoÄ±	treats
tÄ±aotua	adjusts
tÄ±apaq	back
tÄ±aqboqcÄ±ra	brown vonstira
tÄ±aqge	street market
tÄ±aqmuqshoaÄ±sÄ±u	sac-winged bat
tÄ±aqsuhulÄ±q	brown hyena
tÄ±azÄ±u	negative number
tÄ±aÄ±bÄ±o	jar
tÄ±aÄ±chao	cart
tÄ±bumeo	misses
tÄ±bÄ±a	tibia
tÄ±bÄ±ao	loses
tÄ±bÄ±kÄ±qme	television show
tÄ±caÄ±	stout
tÄ±chu	goes via
tÄ±chÄ±aqsho	notices
tÄ±cuao	across
tÄ±cuao	across
tÄ±daofuÄ±	regularly placed
tÄ±dÄ±bu	banned
tÄ±dÄ±bu	is banned
tÄ±ebo	covered
tÄ±eboe	packaging
tÄ±echate	velarized
tÄ±echoa	dub
tÄ±ecÄ±a	naked
tÄ±efuq	coat
tÄ±ehua	skin
tÄ±ehuashoaÄ±	colugo
tÄ±emu	covered
tÄ±eqbea	turn
tÄ±eqbÄ±ao	lost
tÄ±eqchao	train car
tÄ±eqchÄ±eq	crossroads
tÄ±eqfa	goes along path
tÄ±eqguao	fork in the road
tÄ±eqgue	has trajectory
tÄ±eqkoaÄ±	network of roads
tÄ±eqkÄ±u	unobstructed
tÄ±eshaqtÄ±	post-velar
tÄ±ete	covered
tÄ±etoa	subtitles
tÄ±etÄ±atÄ±	pre-velar
tÄ±etÄ±aÄ±	lidded container
tÄ±gaq	stays with
tÄ±gaÄ±	finds
tÄ±joaÄ±	tries to locate
tÄ±laÄ±	at sign
tÄ±luoq	is aligned with
tÄ±luoqcheo	co-aligned
tÄ±lÄ±a	linden
tÄ±me	crowd
tÄ±moq	thyme
tÄ±moy	lost
tÄ±mÄ±a	holds many
tÄ±mÄ±q	omnipresent
tÄ±nhuodÄ±u	composition
tÄ±nÄ±ka	place-marker
tÄ±oqchue	chain
tÄ±oqchuetoaÄ±	link in a chain
tÄ±oqheq	is a vault
tÄ±qbo	Squamata
tÄ±qloha	tin
tÄ±qnhuo	grid, table
tÄ±qra	tiger
tÄ±qsa	scaly
tÄ±qsaoro	scaled reptile
tÄ±qtÄ±	stings
tÄ±rÄ±geteÄ±	owl
tÄ±se	location
tÄ±se	presence
tÄ±shagÄ±q	leaves place
tÄ±shagÄ±q	departs
tÄ±shatua	brings
tÄ±shatÄ±	T-shirt
tÄ±shaÄ±	leaves
tÄ±sho	appears at
tÄ±shu	paper tissue
tÄ±shuÄ±	hidden
tÄ±sue	summons
tÄ±tanÄ±um	titanium
tÄ±teÄ±	layout
tÄ±toateÄ±	locative case
tÄ±tua	puts
tÄ±tÄ±ao	belongs in
tÄ±udÄ±u	logic
tÄ±udÄ±utoaq	logical language
tÄ±udÄ±uzu	logical language
tÄ±ufuaq	flowchart
tÄ±ujeo	therefore so
tÄ±utaq	self-justifying
u'upoq	"woo woo" person
ua	dipshit
uage	amazing
ualaq	wah-wah sound
uane	is as much as
ubula	human uvula
ubula	uvula
ubulalaq	uvular consonant
ubulatÄ±	uvular
uchÄ±	sex phenotype
uchÄ±jeqpÄ±a	same-sex sibling
ugÄ±	fair
ugÄ±jÄ±aq	heaven
ugÄ±toÄ±	treats
uhuÄ±	unfair
uhuÄ±jÄ±aq	hell
ujoq	club
ukulele	ukulele
ukyraÄ±nagua	Ukraine
umaqkaro	Arabian tahr
umÄ±bo	ours
umÄ±fuaq	group selfie
uqsaqbuce	USB port
uranÄ±um	Uranium
usonakafe	caffe americano
usoq	imperial unit
utube	YouTube
utubeche	youtuber
uy'u	uwus
uÄ±bo	slug
yqgy	swallows
zabadÄ±	Malagasy civet
zabÄ±ekafe	instant coffee
zabÄ±ekoycheo	chat
zafeao	nervous
zafeao	feels nervous
zam	unlikely
zao	knows
zaofaÄ±	well-known
zaomu	familiar
zaomumÄ±a	famous
zaomÄ±a	famous
zaopuÄ±	famous
zaq	appears
zaqgÄ±q	disappears
zaqlo	pomegranate
zaqlopÄ±o	garnet
zaqlÄ±nhaq	Tibetan antelope
zaqneq	tough luck
zaqrÄ±u	reappears
zaqshÄ±y	elusive
zaqtua	conjures
zaratushytyrachÄ±	Zoroastrian
zaru	warns
zarulaÄ±	warning glyph
zaruse	warning
zasoq	is up next
zaza	marijuana
zaÄ±	feels hope
zaÄ±cÄ±a	feels despair
zaÄ±se	hope
zaÄ±zu	Esperanto
ze	liquid
zenadaÄ±	elastic
zeo	fruit
zeo	fruit
zeokoaq	ripe
zeoloq	chilli
zeomuaome	orchard
zeonam	fruit bread
zeonao	fruit juice
zeonao	fruit juice
zeorÄ±aq	orchard
zeosaÄ±	fruit
zeoseaÄ±	cider
zeoze	juice
zeozy	juice
zeqbudachuaq	Zen Buddhism
zero	number 0
zoaÄ±ge	suspicious
zoaÄ±pulua	legend
zobo	trousers
zonaozo	condescends
zoqbÄ±	zombie
zoro	short-eared dog
zorÄ±la	striped polecat
zouku	steel
zuaq	is the property
zuche	linguist
zuche	linguist
zuchoq	uses language
zuchÄ±e	learns language
zudeq	knows language
zudÄ±u	linguistics
zudÄ±uche	linguist
zuedoa	lends property
zuejuao	arrangement
zuenua	borrows property
zueq	broken
zueqchoq	wears out
zueqdea	beats up
zuerÄ±aq	makeshift site
zueteq	pays deposit
zuetue	emergency
zugoeq	language barrier
zuhenofÄ±eq	translates
zuhey	is
zujuaokao	grammar
zukÄ±nÄ±	zucchini
zulaqdÄ±u	phonetics
zulaqteÄ±	linguistic tone
zulo	is a word
zulucu	language game
zumuÄ±	meaning
zumuÄ±bo	has meaning
zuno	is in language
zunÄ±eq	is unskilled
zuoty	some zÅ‚oty
zupoq	language person
zuru	electricity
zuruhaqgu	electric eel
zuruhÄ±ao	electrocutes
zurukÄ±oq	ball lightning
zurune	electric charge
zurutoaÄ±	electron
zurÄ±oq	dialect
zusoÄ±	Â«jbosoiÂ»
zuydea	beats up
zuzao	knows language
zÄ±a	emits
zÄ±abÄ±deo	video livestream
zÄ±achome	firefly
zÄ±ahaqkea	microwave oven
zÄ±ase	radiation
zÄ±azÄ±a	sparkles
zÄ±choa	grunts no
zÄ±ekuq	mentiones
zÄ±etao	points at
zÄ±kaÄ±kuq	messages
zÄ±kuq	messages
zÄ±q	electronic
zÄ±q'ahonuaÄ±	NFT
zÄ±qjao	happens remotely
zÄ±qjÄ±o	server
zÄ±qky	zinc
zÄ±qkÄ±	hacky
zÄ±qkÄ±	zinc
zÄ±qmy	byte
zÄ±qnhuo	array
zÄ±qpeq	web page
zÄ±qrÄ±aq	online venue
zÄ±qtoa	computer word
zÄ±qtoaÄ±	bit
zÄ±qtÄ±zua	kicks
zÄ±rykonÄ±umy	zirconium
zÄ±rykoq	zircon
zÄ±u	number
zÄ±ubuzÄ±u	NaN
zÄ±uhuaqjeq	â‰¥
zÄ±ulaÄ±toaÄ±	digit
zÄ±ushuÄ±	encrypted
zÄ±ushuÄ±cÄ±a	unencrypted
Ã¡hoq	you
Ä±dafÄ±ty	Eid al-Fitr
Ä±deÄ±	panics
Ä±dojeq	hydrogen
Ä±goluaq	play Go together
Ä±gotoq	Go board
Ä±jo	shows
Ä±loqmys	idiot.
Ä±ma	feels present
Ä±mebo	ours
Ä±mele	email
Ä±meÄ±	email
Ä±meÄ±chÄ±u	email address
Ä±meÄ±dÄ±eq	emails
Ä±mogy	Imbolc
Ä±oqhashoa	Yom HaShoah
Ä±orozu	myriad
Ä±q'Ä±qku	letter Iq
Ä±qcy	scalar quantity
Ä±qdoa	transfers
Ä±qdojuq	receives
Ä±qfylueqtÄ±a	flu
Ä±qku	anvil
Ä±qlu	igloo
Ä±qlÄ±	English
Ä±qlÄ±zu	English language
Ä±qlÄ±zu'aÄ±	Englishism
Ä±qnua	takes away
Ä±qse	jade
Ä±qserÄ±q	jade-colored
Ä±rabadÄ±depÄ±	snubfin dolphin
Ä±rueboe	sail
Ä±ruefa	sails
Ä±ruekea	fan
Ä±ruemeaq	sailboat
Ä±ruesÄ±oq	wind turbine
Ä±sheÄ±	Ä±s a descender
Ä±shy	keymashes
Ä±sylamychuaq	Islam
Ä±sÄ±kuÄ±	Ithkuil.
Ä±ulua	true story
Ä±um	chemical element
Ä±ê¡e	high-pitched
ê¡ampÄ±rÄ±	vampire
ê¡ase	proposition
ê¡em	intense
ê¡emuoÄ±hajÄ±aÄ±hoa	mobile phone
ê¡eê¡a	letter ê 
ê¡ogo	wug
ê¡ogoq	Vogon
ê¡oka	wok
ê¡oê¡o	yo-yo
